AAAAAATCTGT -> AAAAATCTGTG
AAAAAGAAGTG -> AAAAGAAGTGC
AAAAATCTGTG -> AAAATCTGTGA
AAAAGAAGTGC -> AAAGAAGTGCG
AAAAGATCTCA -> AAAGATCTCAT
AAAAGGTATGA -> AAAGGTATGAC
AAAATCTGTGA -> AAATCTGTGAT
AAAATTGGCCA -> AAATTGGCCAT
AAACACTACGT -> AACACTACGTT
AAACATAGCCT -> AACATAGCCTG
AAACGGTTCCC -> AACGGTTCCCA
AAACTCCTCCG -> AACTCCTCCGC
AAAGAAGTGCG -> AAGAAGTGCGT
AAAGACCTTCC -> AAGACCTTCCC
AAAGACTCCCT -> AAGACTCCCTC
AAAGATACCAC -> AAGATACCACT
AAAGATCTCAT -> AAGATCTCATC
AAAGATCTCCA -> AAGATCTCCAC
AAAGCATAATT -> AAGCATAATTT
AAAGGAACGTA -> AAGGAACGTAC
AAAGGGAAAAG -> AAGGGAAAAGA
AAAGGTATGAC -> AAGGTATGACT
AAATAGACGAT -> AATAGACGATG
AAATATCGGTG -> AATATCGGTGA
AAATATGACAA -> AATATGACAAA
AAATCGATCAG -> AATCGATCAGC
AAATCGGTATT -> AATCGGTATTT
AAATCTGTGAT -> AATCTGTGATA
AAATTGCGCGG -> AATTGCGCGGT
AAATTGGCCAT -> AATTGGCCATC
AAATTGTATAC -> AATTGTATACT
AAATTTGTCCA -> AATTTGTCCAG
AACACTACGTT -> ACACTACGTTA
AACACTTCCTA -> ACACTTCCTAC
AACAGAATTCC -> ACAGAATTCCG
AACAGATGTAT -> ACAGATGTATC
AACATAGCCTG -> ACATAGCCTGG
AACATATCCGG -> ACATATCCGGT
AACCACAACGC -> ACCACAACGCA
AACCATTTTCT -> ACCATTTTCTG
AACCTATAAAT -> ACCTATAAATA
AACGATGAGCC -> ACGATGAGCCA
AACGCATACCC -> ACGCATACCCC
AACGCATCAGA -> ACGCATCAGAA
AACGGATGACG -> ACGGATGACGG
AACGGGGGCCG -> ACGGGGGCCGA
AACGGTTCCCA -> ACGGTTCCCAG
AACGTACCCCG -> ACGTACCCCGG
AACTCCTCCGC -> ACTCCTCCGCA
AAGAAAGGGAA -> AGAAAGGGAAA
AAGAAATTGCG -> AGAAATTGCGC
AAGAAGTGCGT -> AGAAGTGCGTT
AAGACCTTCCC -> AGACCTTCCCG
AAGACGGATGC -> AGACGGATGCA
AAGACTAGTAT -> AGACTAGTATA
AAGACTCCCTC -> AGACTCCCTCT
AAGACTCGTGC -> AGACTCGTGCG
AAGAGATGAGC -> AGAGATGAGCA
AAGAGCTTGCT -> AGAGCTTGCTG
AAGATACCACT -> AGATACCACTC
AAGATCGCTGT -> AGATCGCTGTC
AAGATCTCATC -> AGATCTCATCA
AAGATCTCCAC -> AGATCTCCACA
AAGCACTAATT -> AGCACTAATTA
AAGCATAATTT -> AGCATAATTTG
AAGCCCCGTGG -> AGCCCCGTGGT
AAGCTCGTAAA -> AGCTCGTAAAG
AAGCTTGGCAA -> AGCTTGGCAAC
AAGGAACGTAC -> AGGAACGTACC
AAGGACAGGCT -> AGGACAGGCTA
AAGGCAGGTGA -> AGGCAGGTGAT
AAGGCGGGGAC -> AGGCGGGGACT
AAGGGAAAAGA -> AGGGAAAAGAT
AAGGGTATATA -> AGGGTATATAA
AAGGTATGACT -> AGGTATGACTA
AAGTAGCGCCA -> AGTAGCGCCAG
AAGTATTTAGT -> AGTATTTAGTA
AAGTCTTTTAT -> AGTCTTTTATT
AAGTGAGGTGT -> AGTGAGGTGTC
AAGTGCGTTCG -> AGTGCGTTCGG
AAGTTGCGCTG -> AGTTGCGCTGC
AAGTTGCGTAA -> AGTTGCGTAAG
AAGTTGGGGGA -> AGTTGGGGGAA
AATAACATATC -> ATAACATATCC
AATAAGCTCGT -> ATAAGCTCGTA
AATAATACAGG -> ATAATACAGGT
AATACAGGTAC -> ATACAGGTACT
AATAGACGATG -> ATAGACGATGT
AATAGCTTAGC -> ATAGCTTAGCA
AATATCGGTGA -> ATATCGGTGAG
AATATGACAAA -> ATATGACAAAC
AATCACGGACG -> ATCACGGACGT
AATCAGCCTTC -> ATCAGCCTTCC
AATCATGATCT -> ATCATGATCTT
AATCGATCAGC -> ATCGATCAGCT
AATCGCATTAA -> ATCGCATTAAG
AATCGGTATTT -> ATCGGTATTTT
AATCTGTGATA -> ATCTGTGATAG
AATCTGTTCAG -> ATCTGTTCAGC
AATGCGTGACT -> ATGCGTGACTC
AATGTGAATGC -> ATGTGAATGCG
AATGTTCTTGG -> ATGTTCTTGGT
AATTAATAACA -> ATTAATAACAT
AATTACCTGCG -> ATTACCTGCGT
AATTCCGGCAG -> ATTCCGGCAGT
AATTGCGCGGT -> ATTGCGCGGTC
AATTGGCCATC -> ATTGGCCATCC
AATTGTATACT -> ATTGTATACTG
AATTTGCTGGT -> ATTTGCTGGTC
AATTTGTCCAG -> ATTTGTCCAGA
ACAAAAGGTAT -> CAAAAGGTATG
ACAAACGGTTC -> CAAACGGTTCC
ACAACGCATAC -> CAACGCATACC
ACAAGTATTTA -> CAAGTATTTAG
ACAATCAGCCT -> CAATCAGCCTT
ACAATTAATAA -> CAATTAATAAC
ACACGAACGGG -> CACGAACGGGG
ACACTACGTTA -> CACTACGTTAC
ACACTAGGCTA -> CACTAGGCTAT
ACACTCCTGCT -> CACTCCTGCTC
ACACTTCCTAC -> CACTTCCTACA
ACAGAATTCCG -> CAGAATTCCGG
ACAGACAATCA -> CAGACAATCAG
ACAGACGATGT -> CAGACGATGTA
ACAGAGTTCAG -> CAGAGTTCAGC
ACAGATGTATC -> CAGATGTATCG
ACAGCGTGAGA -> CAGCGTGAGAT
ACAGGAATCGC -> CAGGAATCGCA
ACAGGCTATGG -> CAGGCTATGGG
ACAGGTACTTG -> CAGGTACTTGT
ACAGTATATTG -> CAGTATATTGC
ACAGTCTAATA -> CAGTCTAATAA
ACAGTGTAAAC -> CAGTGTAAACA
ACATAGCCTGG -> CATAGCCTGGG
ACATATCCGGT -> CATATCCGGTT
ACATCGCTTCA -> CATCGCTTCAT
ACATCTTGGCC -> CATCTTGGCCA
ACATGTCGCAA -> CATGTCGCAAA
ACATTCATGAC -> CATTCATGACC
ACATTGATACA -> CATTGATACAC
ACCAAGAAATT -> CCAAGAAATTG
ACCACAACGCA -> CCACAACGCAT
ACCACTCTTGC -> CCACTCTTGCA
ACCAGATAGCC -> CCAGATAGCCA
ACCATTCAAAG -> CCATTCAAAGA
ACCATTTTCTG -> CCATTTTCTGA
ACCCAAATTGT -> CCCAAATTGTA
ACCCCAAGGCG -> CCCCAAGGCGG
ACCCCGATCGT -> CCCCGATCGTC
ACCCCGGGCAG -> CCCCGGGCAGG
ACCCGATTGGG -> CCCGATTGGGA
ACCCTTCGACC -> CCCTTCGACCT
ACCGACAAAAG -> CCGACAAAAGG
ACCGGGCATCT -> CCGGGCATCTG
ACCGTCGGTTG -> CCGTCGGTTGT
ACCTAGGTTCG -> CCTAGGTTCGT
ACCTATAAATA -> CCTATAAATAT
ACCTCCCTTGG -> CCTCCCTTGGA
ACCTGAGCGAG -> CCTGAGCGAGT
ACCTGCGTCTT -> CCTGCGTCTTA
ACCTTCCCGAA -> CCTTCCCGAAG
ACGAACGGGGG -> CGAACGGGGGC
ACGAAGCTTGG -> CGAAGCTTGGC
ACGAGGCCAGG -> CGAGGCCAGGG
ACGATGAGCCA -> CGATGAGCCAG
ACGATGTAGGT -> CGATGTAGGTA
ACGATGTCTGG -> CGATGTCTGGC
ACGCAGCCTCT -> CGCAGCCTCTG
ACGCATACCCC -> CGCATACCCCA
ACGCATCAGAA -> CGCATCAGAAG
ACGCCCGCTGA -> CGCCCGCTGAC
ACGGACGTTAG -> CGGACGTTAGC
ACGGATGACGG -> CGGATGACGGG
ACGGATGCAAA -> CGGATGCAAAG
ACGGCAGGTCT -> CGGCAGGTCTT
ACGGCGGGCCA -> CGGCGGGCCAC
ACGGGCACTAC -> CGGGCACTACT
ACGGGGGCCGA -> CGGGGGCCGAC
ACGGTTCCCAG -> CGGTTCCCAGT
ACGTACCCCGG -> CGTACCCCGGG
ACGTAGTTCAC -> CGTAGTTCACA
ACGTCATCGCC -> CGTCATCGCCC
ACGTCCTGAGA -> CGTCCTGAGAA
ACGTGTACAGA -> CGTGTACAGAG
ACGTTACATCT -> CGTTACATCTT
ACGTTAGCAAA -> CGTTAGCAAAA
ACTAACCTATA -> CTAACCTATAA
ACTAATTACCT -> CTAATTACCTG
ACTACAATTAA -> CTACAATTAAT
ACTACGTTACA -> CTACGTTACAT
ACTACTAGAAG -> CTACTAGAAGA
ACTACTGCGAG -> CTACTGCGAGT
ACTACTGGCGC -> CTACTGGCGCA
ACTAGAAGAGA -> CTAGAAGAGAT
ACTAGGCGATA -> CTAGGCGATAA
ACTAGGCTATA -> CTAGGCTATAC
ACTAGTATAGA -> CTAGTATAGAT
ACTATCAGGCA -> CTATCAGGCAG
ACTATCGACCA -> CTATCGACCAA
ACTCACACTCC -> CTCACACTCCT
ACTCAGCTGGA -> CTCAGCTGGAC
ACTCCCTCTGC -> CTCCCTCTGCT
ACTCCTCCGCA -> CTCCTCCGCAC
ACTCCTGCTCA -> CTCCTGCTCAA
ACTCGTAACAG -> CTCGTAACAGA
ACTCGTAGCTC -> CTCGTAGCTCG
ACTCGTGCGCT -> CTCGTGCGCTC
ACTCTTGCATC -> CTCTTGCATCG
ACTGACTAGGC -> CTGACTAGGCG
ACTGAGAACAG -> CTGAGAACAGA
ACTGAGTACAT -> CTGAGTACATC
ACTGCGAGGAG -> CTGCGAGGAGG
ACTGCGAGTAC -> CTGCGAGTACC
ACTGGAGATAC -> CTGGAGATACG
ACTGGCGCAAT -> CTGGCGCAATC
ACTTACCGACA -> CTTACCGACAA
ACTTCATTAAT -> CTTCATTAATG
ACTTCCTACAA -> CTTCCTACAAG
ACTTGAAGGGT -> CTTGAAGGGTA
ACTTGACCCGA -> CTTGACCCGAT
ACTTGTTAAAT -> CTTGTTAAATA
AGAAAGGGAAA -> GAAAGGGAAAA
AGAAATTGCGC -> GAAATTGCGCG
AGAACAGAATT -> GAACAGAATTC
AGAAGAGATGA -> GAAGAGATGAG
AGAAGAGCTTG -> GAAGAGCTTGC
AGAAGTGAGGT -> GAAGTGAGGTG
AGAAGTGCGTT -> GAAGTGCGTTC
AGAAGTTGCGC -> GAAGTTGCGCT
AGAATTCCGGC -> GAATTCCGGCA
AGACAATCAGC -> GACAATCAGCC
AGACAGTGTAA -> GACAGTGTAAA
AGACCTTCCCG -> GACCTTCCCGA
AGACGATGTAG -> GACGATGTAGG
AGACGATGTCT -> GACGATGTCTG
AGACGGATGCA -> GACGGATGCAA
AGACGTCATCG -> GACGTCATCGC
AGACTAGTATA -> GACTAGTATAG
AGACTCCCTCT -> GACTCCCTCTG
AGACTCGTGCG -> GACTCGTGCGC
AGAGACGTCAT -> GAGACGTCATC
AGAGATGAGCA -> GAGATGAGCAG
AGAGATGCCAG -> GAGATGCCAGA
AGAGCGTACCT -> GAGCGTACCTC
AGAGCTTGCTG -> GAGCTTGCTGA
AGAGTGATCCT -> GAGTGATCCTG
AGAGTTCAGCC -> GAGTTCAGCCT
AGAGTTGGATG -> GAGTTGGATGA
AGATAAACTCC -> GATAAACTCCT
AGATACCACTC -> GATACCACTCT
AGATACGCAGC -> GATACGCAGCC
AGATAGCCAGG -> GATAGCCAGGC
AGATAGTACAG -> GATAGTACAGA
AGATCACTACA -> GATCACTACAA
AGATCGCTGAT -> GATCGCTGATC
AGATCGCTGTC -> GATCGCTGTCC
AGATCTCATCA -> GATCTCATCAT
AGATCTCCACA -> GATCTCCACAT
AGATCTTGTAG -> GATCTTGTAGT
AGATGAGCAGC -> GATGAGCAGCA
AGATGATTTCC -> GATGATTTCCA
AGATGCCAGAG -> GATGCCAGAGC
AGATGTATCGG -> GATGTATCGGT
AGATTATGTCG -> GATTATGTCGT
AGCAAAAAATC -> GCAAAAAATCT
AGCAAAATTGG -> GCAAAATTGGC
AGCAAGGCAGG -> GCAAGGCAGGT
AGCACTAATTA -> GCACTAATTAC
AGCAGCAAGGC -> GCAGCAAGGCA
AGCATAATTTG -> GCATAATTTGC
AGCCAGCTTAT -> GCCAGCTTATT
AGCCAGGCTAC -> GCCAGGCTACT
AGCCATCCGAC -> GCCATCCGACT
AGCCCAGGTTG -> GCCCAGGTTGG
AGCCCCGTGGT -> GCCCCGTGGTT
AGCCCGTATAG -> GCCCGTATAGC
AGCCGTCACTG -> GCCGTCACTGA
AGCCTCTGGGC -> GCCTCTGGGCC
AGCCTGCGGAG -> GCCTGCGGAGG
AGCCTGGGTGT -> GCCTGGGTGTG
AGCCTTCCACA -> GCCTTCCACAC
AGCGACTCGTA -> GCGACTCGTAG
AGCGAGTTACG -> GCGAGTTACGA
AGCGCCAGGAT -> GCGCCAGGATC
AGCGCGCCGCC -> GCGCGCCGCCG
AGCGCTCCCCA -> GCGCTCCCCAT
AGCGTAAAGCA -> GCGTAAAGCAT
AGCGTACCTCC -> GCGTACCTCCC
AGCGTGAGATC -> GCGTGAGATCT
AGCTCGGAAAT -> GCTCGGAAATC
AGCTCGTAAAG -> GCTCGTAAAGA
AGCTGGACAGT -> GCTGGACAGTA
AGCTGGGAAGA -> GCTGGGAAGAC
AGCTGTCTTGT -> GCTGTCTTGTC
AGCTTAGCAAA -> GCTTAGCAAAA
AGCTTATTCGA -> GCTTATTCGAC
AGCTTGCTGAC -> GCTTGCTGACT
AGCTTGGCAAC -> GCTTGGCAACC
AGCTTGGTTGT -> GCTTGGTTGTA
AGGAACGTACC -> GGAACGTACCC
AGGAATCGCAT -> GGAATCGCATT
AGGACAGGCTA -> GGACAGGCTAT
AGGAGGATCAG -> GGAGGATCAGG
AGGATCAGACA -> GGATCAGACAG
AGGATCAGGCG -> GGATCAGGCGG
AGGCAGGTGAT -> GGCAGGTGATT
AGGCAGTAATC -> GGCAGTAATCA
AGGCATAAAGG -> GGCATAAAGGA
AGGCCAGGGTT -> GGCCAGGGTTA
AGGCCTGCTTA -> GGCCTGCTTAG
AGGCGATAATC -> GGCGATAATCA
AGGCGGGGACT -> GGCGGGGACTT
AGGCGGTGCAC -> GGCGGTGCACA
AGGCTACTTAC -> GGCTACTTACC
AGGCTATACAG -> GGCTATACAGC
AGGCTATGGGT -> GGCTATGGGTT
AGGCTTCGCTA -> GGCTTCGCTAA
AGGGAAAAGAT -> GGGAAAAGATC
AGGGTATATAA -> GGGTATATAAA
AGGGTTAGATT -> GGGTTAGATTA
AGGTACTTGTT -> GGTACTTGTTA
AGGTAGATAAA -> GGTAGATAAAC
AGGTATAGAGT -> GGTATAGAGTG
AGGTATGACTA -> GGTATGACTAC
AGGTCCCCGCT -> GGTCCCCGCTC
AGGTCCGTACG -> GGTCCGTACGG
AGGTCTTCGTA -> GGTCTTCGTAG
AGGTGATTTCT -> GGTGATTTCTA
AGGTGCTAAGT -> GGTGCTAAGTT
AGGTGTCCCAC -> GGTGTCCCACA
AGGTTAGATAG -> GGTTAGATAGT
AGGTTCGTTTG -> GGTTCGTTTGG
AGGTTGGCCGA -> GGTTGGCCGAT
AGTAATCACGG -> GTAATCACGGA
AGTACAGACGA -> GTACAGACGAT
AGTACATCGCT -> GTACATCGCTT
AGTACCGTCGG -> GTACCGTCGGT
AGTACTGACTA -> GTACTGACTAG
AGTAGCGCCAG -> GTAGCGCCAGG
AGTAGCTGGGA -> GTAGCTGGGAA
AGTATAGATCA -> GTATAGATCAC
AGTATATTGCT -> GTATATTGCTA
AGTATCAAGTC -> GTATCAAGTCT
AGTATTACTAT -> GTATTACTATC
AGTATTTAGTA -> GTATTTAGTAT
AGTCATATTCA -> GTCATATTCAG
AGTCGTAGGTA -> GTCGTAGGTAT
AGTCTAATAAG -> GTCTAATAAGC
AGTCTTTTATT -> GTCTTTTATTT
AGTGAAGGACA -> GTGAAGGACAG
AGTGAGGTGTC -> GTGAGGTGTCC
AGTGATCCTGT -> GTGATCCTGTG
AGTGCAAGAAA -> GTGCAAGAAAG
AGTGCGTTCGG -> GTGCGTTCGGT
AGTGGACCATT -> GTGGACCATTC
AGTGTAAACAC -> GTGTAAACACT
AGTTACGAGGC -> GTTACGAGGCC
AGTTCACAGAC -> GTTCACAGACA
AGTTCAGCCTG -> GTTCAGCCTGC
AGTTCTTCGCC -> GTTCTTCGCCT
AGTTGCGCTGC -> GTTGCGCTGCC
AGTTGCGTAAG -> GTTGCGTAAGA
AGTTGGATGAT -> GTTGGATGATA
AGTTGGGGGAA -> GTTGGGGGAAC
AGTTTACGGCG -> GTTTACGGCGG
ATAAACTCCTC -> TAAACTCCTCC
ATAAAGGAACG -> TAAAGGAACGT
ATAAATATCGG -> TAAATATCGGT
ATAAATATGAC -> TAAATATGACA
ATAACATATCC -> TAACATATCCG
ATAAGCCCCGT -> TAAGCCCCGTG
ATAAGCTCGTA -> TAAGCTCGTAA
ATAATACAGGT -> TAATACAGGTA
ATAATCATGAT -> TAATCATGATC
ATAATTTGCTG -> TAATTTGCTGG
ATACACTAGGC -> TACACTAGGCT
ATACAGCGTGA -> TACAGCGTGAG
ATACAGGTACT -> TACAGGTACTT
ATACCACTCTT -> TACCACTCTTG
ATACCCCAAGG -> TACCCCAAGGC
ATACGCAGCCT -> TACGCAGCCTC
ATACGTAGTTC -> TACGTAGTTCA
ATACTACTGCG -> TACTACTGCGA
ATACTGGAGAT -> TACTGGAGATA
ATAGAAGAGCT -> TAGAAGAGCTT
ATAGACGATGT -> TAGACGATGTC
ATAGAGTGATC -> TAGAGTGATCC
ATAGATCACTA -> TAGATCACTAC
ATAGCCAGGCT -> TAGCCAGGCTA
ATAGCCTGGGT -> TAGCCTGGGTG
ATAGCGACTCG -> TAGCGACTCGT
ATAGCGTAAAG -> TAGCGTAAAGC
ATAGCTTAGCA -> TAGCTTAGCAA
ATAGGTCCCCG -> TAGGTCCCCGC
ATAGTACAGAC -> TAGTACAGACG
ATATAAATATG -> TATAAATATGA
ATATAAGCCCC -> TATAAGCCCCG
ATATCACGAAG -> TATCACGAAGC
ATATCCGGTTG -> TATCCGGTTGT
ATATCGGTGAG -> TATCGGTGAGG
ATATCTCGGAA -> TATCTCGGAAT
ATATGACAAAC -> TATGACAAACG
ATATTCAGTGC -> TATTCAGTGCA
ATATTGCTAAA -> TATTGCTAAAA
ATATTTATTTG -> TATTTATTTGC
ATCAAGTCTTT -> TCAAGTCTTTT
ATCACGAAGCT -> TCACGAAGCTT
ATCACGGACGT -> TCACGGACGTT
ATCACTACAAT -> TCACTACAATT
ATCAGAAGTTG -> TCAGAAGTTGC
ATCAGACAGTG -> TCAGACAGTGT
ATCAGCCTTCC -> TCAGCCTTCCA
ATCAGCTTGGT -> TCAGCTTGGTT
ATCAGGCAGTA -> TCAGGCAGTAA
ATCAGGCGGTG -> TCAGGCGGTGC
ATCATGATCTT -> TCATGATCTTC
ATCATTACGTC -> TCATTACGTCC
ATCCCCCTGTC -> TCCCCCTGTCA
ATCCGACTTGA -> TCCGACTTGAC
ATCCGGTTGTC -> TCCGGTTGTCC
ATCCGTCTGCT -> TCCGTCTGCTC
ATCCTGTGGCA -> TCCTGTGGCAA
ATCGACCAAGA -> TCGACCAAGAA
ATCGATCAGCT -> TCGATCAGCTT
ATCGCATCTTT -> TCGCATCTTTT
ATCGCATTAAG -> TCGCATTAAGT
ATCGCCCCTCC -> TCGCCCCTCCA
ATCGCTGATCG -> TCGCTGATCGG
ATCGCTGTCCT -> TCGCTGTCCTC
ATCGCTTCATG -> TCGCTTCATGA
ATCGGGAACGC -> TCGGGAACGCA
ATCGGTATTTT -> TCGGTATTTTG
ATCGGTGAGGT -> TCGGTGAGGTC
ATCGGTTCTGC -> TCGGTTCTGCG
ATCGTCCTGCT -> TCGTCCTGCTT
ATCTCATCATT -> TCTCATCATTA
ATCTCCACATG -> TCTCCACATGT
ATCTCGGAATG -> TCTCGGAATGT
ATCTGCCCGTA -> TCTGCCCGTAG
ATCTGTGATAG -> TCTGTGATAGA
ATCTGTTCAGC -> TCTGTTCAGCC
ATCTTCAGTCG -> TCTTCAGTCGT
ATCTTGGCCAT -> TCTTGGCCATA
ATCTTGTAGTT -> TCTTGTAGTTC
ATCTTTTCTCC -> TCTTTTCTCCC
ATGACAAACGG -> TGACAAACGGT
ATGACAGGAAT -> TGACAGGAATC
ATGACCCTTCG -> TGACCCTTCGA
ATGACGGGCAC -> TGACGGGCACT
ATGACTACTGG -> TGACTACTGGC
ATGAGCAGCAA -> TGAGCAGCAAG
ATGAGCCAGCT -> TGAGCCAGCTT
ATGATACTACT -> TGATACTACTG
ATGATCTTCAG -> TGATCTTCAGT
ATGATTTCCAG -> TGATTTCCAGC
ATGCAAAGATC -> TGCAAAGATCT
ATGCCAGAGCG -> TGCCAGAGCGT
ATGCGTGACTC -> TGCGTGACTCA
ATGGGTTAGAT -> TGGGTTAGATC
ATGTAGGTAGA -> TGTAGGTAGAT
ATGTATCGGTT -> TGTATCGGTTC
ATGTCGCAAAC -> TGTCGCAAACA
ATGTCGTAGAT -> TGTCGTAGATG
ATGTCTGGCTT -> TGTCTGGCTTC
ATGTGAATGCG -> TGTGAATGCGT
ATGTGTATATT -> TGTGTATATTT
ATGTTCTTGGT -> TGTTCTTGGTT
ATTAAGTAGCG -> TTAAGTAGCGC
ATTAATAACAT -> TTAATAACATA
ATTAATGTTCT -> TTAATGTTCTT
ATTACCTGCGT -> TTACCTGCGTC
ATTACGTCCTG -> TTACGTCCTGA
ATTACTATCAG -> TTACTATCAGG
ATTATGTCGTA -> TTATGTCGTAG
ATTCAAAGACC -> TTCAAAGACCT
ATTCAGTGCAA -> TTCAGTGCAAG
ATTCATGACCC -> TTCATGACCCT
ATTCCGGCAGT -> TTCCGGCAGTG
ATTCGACAGTC -> TTCGACAGTCT
ATTCGCTCCGA -> TTCGCTCCGAT
ATTCGGATTGA -> TTCGGATTGAT
ATTGATACACT -> TTGATACACTA
ATTGATTGGTT -> TTGATTGGTTC
ATTGCGCGGTC -> TTGCGCGGTCC
ATTGCTAAAAA -> TTGCTAAAAAG
ATTGGCCATCC -> TTGGCCATCCG
ATTGGGAGGCT -> TTGGGAGGCTT
ATTGGTTCGAA -> TTGGTTCGAAC
ATTGTATACTG -> TTGTATACTGG
ATTGTCCTAAT -> TTGTCCTAATA
ATTTAGTATCA -> TTTAGTATCAA
ATTTATTTGCC -> TTTATTTGCCT
ATTTCCAGCCG -> TTTCCAGCCGT
ATTTCTACTTC -> TTTCTACTTCA
ATTTCTTCTAA -> TTTCTTCTAAT
ATTTGCCTAGT -> TTTGCCTAGTC
ATTTGCTGGTC -> TTTGCTGGTCG
ATTTGTCCAGA -> TTTGTCCAGAG
ATTTTACCTGA -> TTTTACCTGAG
ATTTTCTGAAG -> TTTTCTGAAGC
ATTTTGTTCGG -> TTTTGTTCGGG
CAAAAAATCTG -> AAAAAATCTGT
CAAAAGGTATG -> AAAAGGTATGA
CAAAATTGGCC -> AAAATTGGCCA
CAAACATAGCC -> AAACATAGCCT
CAAACGGTTCC -> AAACGGTTCCC
CAAAGACCTTC -> AAAGACCTTCC
CAAAGATCTCC -> AAAGATCTCCA
CAAATTGTATA -> AAATTGTATAC
CAACCACAACG -> AACCACAACGC
CAACCATTTTC -> AACCATTTTCT
CAACGCATACC -> AACGCATACCC
CAAGAAAGGGA -> AAGAAAGGGAA
CAAGAAATTGC -> AAGAAATTGCG
CAAGATCGCTG -> AAGATCGCTGT
CAAGGCAGGTG -> AAGGCAGGTGA
CAAGGCGGGGA -> AAGGCGGGGAC
CAAGTATTTAG -> AAGTATTTAGT
CAAGTCTTTTA -> AAGTCTTTTAT
CAATCAGCCTT -> AATCAGCCTTC
CAATCTGTTCA -> AATCTGTTCAG
CAATTAATAAC -> AATTAATAACA
CACAACGCATA -> ACAACGCATAC
CACACGAACGG -> ACACGAACGGG
CACACTCCTGC -> ACACTCCTGCT
CACAGACAATC -> ACAGACAATCA
CACATGTCGCA -> ACATGTCGCAA
CACATTCATGA -> ACATTCATGAC
CACATTGATAC -> ACATTGATACA
CACCCAAATTG -> ACCCAAATTGT
CACCGGGCATC -> ACCGGGCATCT
CACGAACGGGG -> ACGAACGGGGG
CACGAAGCTTG -> ACGAAGCTTGG
CACGCCCGCTG -> ACGCCCGCTGA
CACGGACGTTA -> ACGGACGTTAG
CACTAACCTAT -> ACTAACCTATA
CACTAATTACC -> ACTAATTACCT
CACTACAATTA -> ACTACAATTAA
CACTACGTTAC -> ACTACGTTACA
CACTACTAGAA -> ACTACTAGAAG
CACTAGGCTAT -> ACTAGGCTATA
CACTCCTGCTC -> ACTCCTGCTCA
CACTCGTAACA -> ACTCGTAACAG
CACTCTTGCAT -> ACTCTTGCATC
CACTGAGTACA -> ACTGAGTACAT
CACTTCCTACA -> ACTTCCTACAA
CAGAAGTTGCG -> AGAAGTTGCGC
CAGAATTCCGG -> AGAATTCCGGC
CAGACAATCAG -> AGACAATCAGC
CAGACAGTGTA -> AGACAGTGTAA
CAGACGATGTA -> AGACGATGTAG
CAGAGCGTACC -> AGAGCGTACCT
CAGAGTTCAGC -> AGAGTTCAGCC
CAGAGTTGGAT -> AGAGTTGGATG
CAGATAGCCAG -> AGATAGCCAGG
CAGATGTATCG -> AGATGTATCGG
CAGCAAGGCAG -> AGCAAGGCAGG
CAGCCATCCGA -> AGCCATCCGAC
CAGCCCGTATA -> AGCCCGTATAG
CAGCCGTCACT -> AGCCGTCACTG
CAGCCTCTGGG -> AGCCTCTGGGC
CAGCCTGCGGA -> AGCCTGCGGAG
CAGCCTTCCAC -> AGCCTTCCACA
CAGCGTGAGAT -> AGCGTGAGATC
CAGCTGGACAG -> AGCTGGACAGT
CAGCTGTCTTG -> AGCTGTCTTGT
CAGCTTATTCG -> AGCTTATTCGA
CAGCTTGGTTG -> AGCTTGGTTGT
CAGGAATCGCA -> AGGAATCGCAT
CAGGATCAGAC -> AGGATCAGACA
CAGGCAGTAAT -> AGGCAGTAATC
CAGGCCTGCTT -> AGGCCTGCTTA
CAGGCGGTGCA -> AGGCGGTGCAC
CAGGCTACTTA -> AGGCTACTTAC
CAGGCTATGGG -> AGGCTATGGGT
CAGGGTTAGAT -> AGGGTTAGATT
CAGGTACTTGT -> AGGTACTTGTT
CAGGTCTTCGT -> AGGTCTTCGTA
CAGGTGATTTC -> AGGTGATTTCT
CAGGTTAGATA -> AGGTTAGATAG
CAGGTTGGCCG -> AGGTTGGCCGA
CAGTAATCACG -> AGTAATCACGG
CAGTACTGACT -> AGTACTGACTA
CAGTAGCTGGG -> AGTAGCTGGGA
CAGTATATTGC -> AGTATATTGCT
CAGTCGTAGGT -> AGTCGTAGGTA
CAGTCTAATAA -> AGTCTAATAAG
CAGTGCAAGAA -> AGTGCAAGAAA
CAGTGGACCAT -> AGTGGACCATT
CAGTGTAAACA -> AGTGTAAACAC
CATAAAGGAAC -> ATAAAGGAACG
CATAATTTGCT -> ATAATTTGCTG
CATACCCCAAG -> ATACCCCAAGG
CATAGCCTGGG -> ATAGCCTGGGT
CATAGCGTAAA -> ATAGCGTAAAG
CATATCCGGTT -> ATATCCGGTTG
CATATCTCGGA -> ATATCTCGGAA
CATATTCAGTG -> ATATTCAGTGC
CATCAGAAGTT -> ATCAGAAGTTG
CATCATTACGT -> ATCATTACGTC
CATCCGACTTG -> ATCCGACTTGA
CATCCGTCTGC -> ATCCGTCTGCT
CATCGCATCTT -> ATCGCATCTTT
CATCGCCCCTC -> ATCGCCCCTCC
CATCGCTTCAT -> ATCGCTTCATG
CATCTGCCCGT -> ATCTGCCCGTA
CATCTTGGCCA -> ATCTTGGCCAT
CATCTTTTCTC -> ATCTTTTCTCC
CATGACAGGAA -> ATGACAGGAAT
CATGACCCTTC -> ATGACCCTTCG
CATGATCTTCA -> ATGATCTTCAG
CATGTCGCAAA -> ATGTCGCAAAC
CATTAAGTAGC -> ATTAAGTAGCG
CATTAATGTTC -> ATTAATGTTCT
CATTACGTCCT -> ATTACGTCCTG
CATTCAAAGAC -> ATTCAAAGACC
CATTCATGACC -> ATTCATGACCC
CATTCGCTCCG -> ATTCGCTCCGA
CATTCGGATTG -> ATTCGGATTGA
CATTGATACAC -> ATTGATACACT
CATTGTCCTAA -> ATTGTCCTAAT
CATTTCTTCTA -> ATTTCTTCTAA
CATTTTCTGAA -> ATTTTCTGAAG
CCAAATTGTAT -> CAAATTGTATA
CCAAGAAATTG -> CAAGAAATTGC
CCAAGGCGGGG -> CAAGGCGGGGA
CCACAACGCAT -> CACAACGCATA
CCACACGAACG -> CACACGAACGG
CCACATGTCGC -> CACATGTCGCA
CCACATTCATG -> CACATTCATGA
CCACGCCCGCT -> CACGCCCGCTG
CCACTCTTGCA -> CACTCTTGCAT
CCAGAGCGTAC -> CAGAGCGTACC
CCAGAGTTGGA -> CAGAGTTGGAT
CCAGATAGCCA -> CAGATAGCCAG
CCAGCCCGTAT -> CAGCCCGTATA
CCAGCCGTCAC -> CAGCCGTCACT
CCAGCTTATTC -> CAGCTTATTCG
CCAGGATCAGA -> CAGGATCAGAC
CCAGGCCTGCT -> CAGGCCTGCTT
CCAGGCTACTT -> CAGGCTACTTA
CCAGGGTTAGA -> CAGGGTTAGAT
CCAGGTTGGCC -> CAGGTTGGCCG
CCAGTACTGAC -> CAGTACTGACT
CCATATCTCGG -> CATATCTCGGA
CCATCCGACTT -> CATCCGACTTG
CCATCCGTCTG -> CATCCGTCTGC
CCATTCAAAGA -> CATTCAAAGAC
CCATTCGCTCC -> CATTCGCTCCG
CCATTCGGATT -> CATTCGGATTG
CCATTTTCTGA -> CATTTTCTGAA
CCCAAATTGTA -> CCAAATTGTAT
CCCAAGGCGGG -> CCAAGGCGGGG
CCCACATTCAT -> CCACATTCATG
CCCAGGTTGGC -> CCAGGTTGGCC
CCCATTCGCTC -> CCATTCGCTCC
CCCATTCGGAT -> CCATTCGGATT
CCCCAAGGCGG -> CCCAAGGCGGG
CCCCATTCGCT -> CCCATTCGCTC
CCCCATTCGGA -> CCCATTCGGAT
CCCCCTGTCAC -> CCCCTGTCACC
CCCCGATCGTC -> CCCGATCGTCC
CCCCGCTCCAG -> CCCGCTCCAGT
CCCCGGGCAGG -> CCCGGGCAGGT
CCCCGTGGTTG -> CCCGTGGTTGC
CCCCTCCAGGC -> CCCTCCAGGCC
CCCCTGTCACC -> CCCTGTCACCC
CCCGAACACTT -> CCGAACACTTC
CCCGAAGACGG -> CCGAAGACGGA
CCCGATCGTCC -> CCGATCGTCCT
CCCGATTGGGA -> CCGATTGGGAG
CCCGCTATGTG -> CCGCTATGTGT
CCCGCTCCAGT -> CCGCTCCAGTA
CCCGCTGACTC -> CCGCTGACTCA
CCCGGGCAGGT -> CCGGGCAGGTT
CCCGTAGTGAA -> CCGTAGTGAAG
CCCGTATAGCG -> CCGTATAGCGA
CCCGTGGTTGC -> CCGTGGTTGCT
CCCTCCAGGCC -> CCTCCAGGCCT
CCCTCTGCTTG -> CCTCTGCTTGA
CCCTGTCACCC -> CCTGTCACCCA
CCCTTACCAGA -> CCTTACCAGAT
CCCTTCGACCT -> CCTTCGACCTA
CCCTTGGACCC -> CCTTGGACCCC
CCGAACACTTC -> CGAACACTTCC
CCGAAGACGGA -> CGAAGACGGAT
CCGACAAAAGG -> CGACAAAAGGT
CCGACGTGTAC -> CGACGTGTACA
CCGACTATCGA -> CGACTATCGAC
CCGACTTGACC -> CGACTTGACCC
CCGATACGTAG -> CGATACGTAGT
CCGATATAAGC -> CGATATAAGCC
CCGATCGTCCT -> CGATCGTCCTG
CCGATTGGGAG -> CGATTGGGAGG
CCGCACTAACC -> CGCACTAACCT
CCGCATTGTCC -> CGCATTGTCCT
CCGCCGCATTG -> CGCCGCATTGT
CCGCTATGTGT -> CGCTATGTGTA
CCGCTCCAGTA -> CGCTCCAGTAC
CCGCTGACTCA -> CGCTGACTCAC
CCGGCAGTGGA -> CGGCAGTGGAC
CCGGGCAGGTT -> CGGGCAGGTTA
CCGGGCATCTG -> CGGGCATCTGC
CCGGTGTTGTA -> CGGTGTTGTAA
CCGGTTGTCCG -> CGGTTGTCCGG
CCGTACGGCAG -> CGTACGGCAGG
CCGTAGTGAAG -> CGTAGTGAAGG
CCGTATAGCGA -> CGTATAGCGAC
CCGTCACTGAG -> CGTCACTGAGT
CCGTCGGTTGT -> CGTCGGTTGTG
CCGTCTGCTCA -> CGTCTGCTCAC
CCGTGGTTGCT -> CGTGGTTGCTT
CCTAATAGCTT -> CTAATAGCTTA
CCTACAAGTAT -> CTACAAGTATT
CCTAGGTTCGT -> CTAGGTTCGTT
CCTAGTCATAT -> CTAGTCATATT
CCTATAAATAT -> CTATAAATATC
CCTATATCACG -> CTATATCACGA
CCTCCAGGCCT -> CTCCAGGCCTG
CCTCCCTTGGA -> CTCCCTTGGAC
CCTCCGCACTA -> CTCCGCACTAA
CCTCGTAAATC -> CTCGTAAATCG
CCTCTGCTTGA -> CTCTGCTTGAG
CCTCTGGGCCC -> CTCTGGGCCCT
CCTGAGAAGTG -> CTGAGAAGTGA
CCTGAGCGAGT -> CTGAGCGAGTT
CCTGCGGAGGT -> CTGCGGAGGTG
CCTGCGTCTTA -> CTGCGTCTTAT
CCTGCTCAACC -> CTGCTCAACCA
CCTGCTTAGCG -> CTGCTTAGCGC
CCTGCTTTGTG -> CTGCTTTGTGT
CCTGGGTGTGA -> CTGGGTGTGAA
CCTGTCACCCA -> CTGTCACCCAA
CCTGTGGCAAG -> CTGTGGCAAGA
CCTTACCAGAT -> CTTACCAGATA
CCTTCCACACG -> CTTCCACACGA
CCTTCCCGAAG -> CTTCCCGAAGA
CCTTCGACCTA -> CTTCGACCTAG
CCTTGGACCCC -> CTTGGACCCCG
CGAACACTTCC -> GAACACTTCCT
CGAACGATGAG -> GAACGATGAGC
CGAACGGGGGC -> GAACGGGGGCC
CGAAGACGGAT -> GAAGACGGATG
CGAAGCTTGGC -> GAAGCTTGGCA
CGACAAAAGGT -> GACAAAAGGTA
CGACAGTCTAA -> GACAGTCTAAT
CGACCAAGAAA -> GACCAAGAAAT
CGACCTAGGTT -> GACCTAGGTTC
CGACGTGTACA -> GACGTGTACAG
CGACTATCGAC -> GACTATCGACC
CGACTCGTAGC -> GACTCGTAGCT
CGACTTGACCC -> GACTTGACCCG
CGAGCCCAGGT -> GAGCCCAGGTT
CGAGGAGGATC -> GAGGAGGATCA
CGAGGCCAGGG -> GAGGCCAGGGT
CGAGTACCGTC -> GAGTACCGTCG
CGAGTTACGAG -> GAGTTACGAGG
CGATAATCATG -> GATAATCATGA
CGATACGTAGT -> GATACGTAGTT
CGATATAAGCC -> GATATAAGCCC
CGATCAGCTTG -> GATCAGCTTGG
CGATCGTCCTG -> GATCGTCCTGC
CGATGAGCCAG -> GATGAGCCAGC
CGATGTAGGTA -> GATGTAGGTAG
CGATGTCTGGC -> GATGTCTGGCT
CGATTGGGAGG -> GATTGGGAGGC
CGCAAACATAG -> GCAAACATAGC
CGCAATCTGTT -> GCAATCTGTTC
CGCACCGGGCA -> GCACCGGGCAT
CGCACTAACCT -> GCACTAACCTA
CGCAGCCTCTG -> GCAGCCTCTGG
CGCATACCCCA -> GCATACCCCAA
CGCATCAGAAG -> GCATCAGAAGT
CGCATCTTTTC -> GCATCTTTTCT
CGCATTAAGTA -> GCATTAAGTAG
CGCATTGTCCT -> GCATTGTCCTA
CGCCAGGATCA -> GCCAGGATCAG
CGCCCCTCCAG -> GCCCCTCCAGG
CGCCCGCTGAC -> GCCCGCTGACT
CGCCGCATTGT -> GCCGCATTGTC
CGCCGCCGCAT -> GCCGCCGCATT
CGCCTATATCA -> GCCTATATCAC
CGCGCCGCCGC -> GCGCCGCCGCA
CGCGCTCTAGT -> GCGCTCTAGTT
CGCGGTCCCGA -> GCGGTCCCGAA
CGCTAAAGATA -> GCTAAAGATAC
CGCTATGTGTA -> GCTATGTGTAT
CGCTCCAGTAC -> GCTCCAGTACT
CGCTCCCCATT -> GCTCCCCATTC
CGCTCCGATAT -> GCTCCGATATA
CGCTCTAGGCA -> GCTCTAGGCAT
CGCTCTAGTTT -> GCTCTAGTTTA
CGCTGACTCAC -> GCTGACTCACA
CGCTGATCGGG -> GCTGATCGGGA
CGCTGCCGACT -> GCTGCCGACTA
CGCTGTCCTCG -> GCTGTCCTCGT
CGCTTCATGAC -> GCTTCATGACA
CGGAAATCGAT -> GGAAATCGATC
CGGAATGTGAA -> GGAATGTGAAT
CGGACGTTAGC -> GGACGTTAGCA
CGGAGGTGCTA -> GGAGGTGCTAA
CGGATGACGGG -> GGATGACGGGC
CGGATGCAAAG -> GGATGCAAAGA
CGGATTGATTG -> GGATTGATTGG
CGGCAGGTCTT -> GGCAGGTCTTC
CGGCAGTGGAC -> GGCAGTGGACC
CGGCGGGCCAC -> GGCGGGCCACG
CGGGAACGCAT -> GGGAACGCATC
CGGGCACTACT -> GGGCACTACTA
CGGGCAGGTTA -> GGGCAGGTTAG
CGGGCATCTGC -> GGGCATCTGCC
CGGGCCACGCC -> GGGCCACGCCC
CGGGGACTTGA -> GGGGACTTGAA
CGGGGGCCGAC -> GGGGGCCGACG
CGGGTCCCGCT -> GGGTCCCGCTA
CGGTATTTTGT -> GGTATTTTGTT
CGGTCCCGAAC -> GGTCCCGAACA
CGGTGAGGTCC -> GGTGAGGTCCG
CGGTGCACATT -> GGTGCACATTG
CGGTGTTGTAA -> GGTGTTGTAAA
CGGTTCATAGC -> GGTTCATAGCG
CGGTTCTGCGC -> GGTTCTGCGCA
CGGTTGTCCGG -> GGTTGTCCGGT
CGGTTGTGGAC -> GGTTGTGGACT
CGTAAAGACTC -> GTAAAGACTCC
CGTAAAGCATA -> GTAAAGCATAA
CGTAAATCGGT -> GTAAATCGGTA
CGTAACAGATG -> GTAACAGATGT
CGTAAGACTAG -> GTAAGACTAGT
CGTACCCCGGG -> GTACCCCGGGC
CGTACCTCCCT -> GTACCTCCCTT
CGTACGGCAGG -> GTACGGCAGGT
CGTAGAGATGC -> GTAGAGATGCC
CGTAGATGATT -> GTAGATGATTT
CGTAGCTCGGA -> GTAGCTCGGAA
CGTAGGTATAG -> GTAGGTATAGA
CGTAGTGAAGG -> GTAGTGAAGGA
CGTAGTTCACA -> GTAGTTCACAG
CGTATAGCGAC -> GTATAGCGACT
CGTCACTGAGT -> GTCACTGAGTA
CGTCATCGCCC -> GTCATCGCCCC
CGTCCTGAGAA -> GTCCTGAGAAG
CGTCCTGCTTT -> GTCCTGCTTTG
CGTCGGTTGTG -> GTCGGTTGTGG
CGTCTGCTCAC -> GTCTGCTCACT
CGTCTTATAGG -> GTCTTATAGGT
CGTGACTCAGC -> GTGACTCAGCT
CGTGAGATCTT -> GTGAGATCTTG
CGTGCGCTCTA -> GTGCGCTCTAG
CGTGGTTGCTT -> GTGGTTGCTTC
CGTGTACAGAG -> GTGTACAGAGT
CGTTACATCTT -> GTTACATCTTG
CGTTAGCAAAA -> GTTAGCAAAAT
CGTTCGGTTCA -> GTTCGGTTCAT
CGTTTGGCCAG -> GTTTGGCCAGC
CTAAAAAGAAG -> TAAAAAGAAGT
CTAAAGATACC -> TAAAGATACCA
CTAACCTATAA -> TAACCTATAAA
CTAAGTTGGGG -> TAAGTTGGGGG
CTAATAAGCTC -> TAATAAGCTCG
CTAATAATACA -> TAATAATACAG
CTAATAGCTTA -> TAATAGCTTAG
CTAATTACCTG -> TAATTACCTGC
CTACAAGTATT -> TACAAGTATTT
CTACAATTAAT -> TACAATTAATA
CTACGTTACAT -> TACGTTACATC
CTACTAGAAGA -> TACTAGAAGAG
CTACTGCGAGT -> TACTGCGAGTA
CTACTGGCGCA -> TACTGGCGCAA
CTACTTACCGA -> TACTTACCGAC
CTACTTCATTA -> TACTTCATTAA
CTAGAAGAGAT -> TAGAAGAGATG
CTAGGCATAAA -> TAGGCATAAAG
CTAGGCGATAA -> TAGGCGATAAT
CTAGGCTATAC -> TAGGCTATACA
CTAGGTTCGTT -> TAGGTTCGTTT
CTAGTATAGAT -> TAGTATAGATC
CTAGTCATATT -> TAGTCATATTC
CTAGTTTACGG -> TAGTTTACGGC
CTATAAATATC -> TATAAATATCG
CTATACAGCGT -> TATACAGCGTG
CTATATCACGA -> TATATCACGAA
CTATCAGGCAG -> TATCAGGCAGT
CTATCGACCAA -> TATCGACCAAG
CTATGGGTTAG -> TATGGGTTAGA
CTATGTGTATA -> TATGTGTATAT
CTCAACCATTT -> TCAACCATTTT
CTCACACTCCT -> TCACACTCCTG
CTCACTCGTAA -> TCACTCGTAAC
CTCAGCTGGAC -> TCAGCTGGACA
CTCATCATTAC -> TCATCATTACG
CTCCACATGTC -> TCCACATGTCG
CTCCAGGCCTG -> TCCAGGCCTGC
CTCCAGTACTG -> TCCAGTACTGA
CTCCCCATTCG -> TCCCCATTCGC,TCCCCATTCGG
CTCCCTCTGCT -> TCCCTCTGCTT
CTCCCTTGGAC -> TCCCTTGGACC
CTCCGATATAA -> TCCGATATAAG
CTCCGCACTAA -> TCCGCACTAAC
CTCCTCCGCAC -> TCCTCCGCACT
CTCCTGCTCAA -> TCCTGCTCAAC
CTCGGAAATCG -> TCGGAAATCGA
CTCGGAATGTG -> TCGGAATGTGA
CTCGTAAAGAC -> TCGTAAAGACT
CTCGTAAATCG -> TCGTAAATCGG
CTCGTAACAGA -> TCGTAACAGAT
CTCGTAGCTCG -> TCGTAGCTCGG
CTCGTGCGCTC -> TCGTGCGCTCT
CTCTAGGCATA -> TCTAGGCATAA
CTCTAGTTTAC -> TCTAGTTTACG
CTCTGCTTGAG -> TCTGCTTGAGT
CTCTGGGCCCT -> TCTGGGCCCTT
CTCTTGCATCG -> TCTTGCATCGC
CTGAAGCACTA -> TGAAGCACTAA
CTGACTAGGCG -> TGACTAGGCGA
CTGACTCACAC -> TGACTCACACT
CTGACTGAGAA -> TGACTGAGAAC
CTGAGAACAGA -> TGAGAACAGAA
CTGAGAAGTGA -> TGAGAAGTGAG
CTGAGCGAGTT -> TGAGCGAGTTA
CTGAGTACATC -> TGAGTACATCG
CTGATCGGGAA -> TGATCGGGAAC
CTGCCCGTAGT -> TGCCCGTAGTG
CTGCCGACTAT -> TGCCGACTATC
CTGCGAGGAGG -> TGCGAGGAGGA
CTGCGAGTACC -> TGCGAGTACCG
CTGCGCACCGG -> TGCGCACCGGG
CTGCGGAGGTG -> TGCGGAGGTGC
CTGCGTCTTAT -> TGCGTCTTATA
CTGCTCAACCA -> TGCTCAACCAT
CTGCTCACTCG -> TGCTCACTCGT
CTGCTTAGCGC -> TGCTTAGCGCG
CTGCTTGAGTA -> TGCTTGAGTAT
CTGCTTTGTGT -> TGCTTTGTGTT
CTGGACAGTAT -> TGGACAGTATA
CTGGAGATACG -> TGGAGATACGC
CTGGCGCAATC -> TGGCGCAATCT
CTGGCTTCAGC -> TGGCTTCAGCT
CTGGGAAGACT -> TGGGAAGACTC
CTGGGCCCTTA -> TGGGCCCTTAC
CTGGGTGTGAA -> TGGGTGTGAAG
CTGGTCGCGCT -> TGGTCGCGCTC
CTGTCACCCAA -> TGTCACCCAAA
CTGTCCTCGTA -> TGTCCTCGTAA
CTGTCTTGTCG -> TGTCTTGTCGA
CTGTGATAGAA -> TGTGATAGAAG
CTGTGGCAAGA -> TGTGGCAAGAT
CTGTTCAGCCA -> TGTTCAGCCAT
CTTACCAGATA -> TTACCAGATAG
CTTACCGACAA -> TTACCGACAAA
CTTAGCAAAAA -> TTAGCAAAAAA
CTTAGCGCGCC -> TTAGCGCGCCG
CTTATAGGTCC -> TTATAGGTCCC
CTTATTCGACA -> TTATTCGACAG
CTTCAGCTGTC -> TTCAGCTGTCT
CTTCAGTCGTA -> TTCAGTCGTAG
CTTCATGACAG -> TTCATGACAGG
CTTCATTAATG -> TTCATTAATGT
CTTCATTTCTT -> TTCATTTCTTC
CTTCCACACGA -> TTCCACACGAA
CTTCCCGAAGA -> TTCCCGAAGAC
CTTCCTACAAG -> TTCCTACAAGT
CTTCGACCTAG -> TTCGACCTAGG
CTTCGCCTATA -> TTCGCCTATAT
CTTCGCTAAAG -> TTCGCTAAAGA
CTTCGTAGAGA -> TTCGTAGAGAT
CTTCTAATAAT -> TTCTAATAATA
CTTGAAGGGTA -> TTGAAGGGTAT
CTTGACCCGAT -> TTGACCCGATT
CTTGAGTATTA -> TTGAGTATTAC
CTTGCATCGCA -> TTGCATCGCAT
CTTGCTGACTG -> TTGCTGACTGA
CTTGGACCCCG -> TTGGACCCCGA
CTTGGCAACCA -> TTGGCAACCAC
CTTGGCCATAT -> TTGGCCATATC
CTTGGTTGAGC -> TTGGTTGAGCG
CTTGGTTGTAG -> TTGGTTGTAGA
CTTGTAGTTCT -> TTGTAGTTCTT
CTTGTCGAGCC -> TTGTCGAGCCC
CTTGTTAAATA -> TTGTTAAATAG
CTTTGTGTTAT -> TTTGTGTTATC
CTTTTATTTTA -> TTTTATTTTAC
CTTTTCTCCCC -> TTTTCTCCCCA
GAAAAGATCTC -> AAAAGATCTCA
GAAAGGGAAAA -> AAAGGGAAAAG
GAAATCGATCA -> AAATCGATCAG
GAAATTGCGCG -> AAATTGCGCGG
GAACACTTCCT -> AACACTTCCTA
GAACAGAATTC -> AACAGAATTCC
GAACGATGAGC -> AACGATGAGCC
GAACGCATCAG -> AACGCATCAGA
GAACGGATGAC -> AACGGATGACG
GAACGGGGGCC -> AACGGGGGCCG
GAACGTACCCC -> AACGTACCCCG
GAAGACGGATG -> AAGACGGATGC
GAAGACTCGTG -> AAGACTCGTGC
GAAGAGATGAG -> AAGAGATGAGC
GAAGAGCTTGC -> AAGAGCTTGCT
GAAGCACTAAT -> AAGCACTAATT
GAAGCTTGGCA -> AAGCTTGGCAA
GAAGGACAGGC -> AAGGACAGGCT
GAAGGGTATAT -> AAGGGTATATA
GAAGTGAGGTG -> AAGTGAGGTGT
GAAGTGCGTTC -> AAGTGCGTTCG
GAAGTTGCGCT -> AAGTTGCGCTG
GAAGTTGCGTA -> AAGTTGCGTAA
GAATCGCATTA -> AATCGCATTAA
GAATGCGTGAC -> AATGCGTGACT
GAATGTGAATG -> AATGTGAATGC
GAATTCCGGCA -> AATTCCGGCAG
GACAAAAGGTA -> ACAAAAGGTAT
GACAAACGGTT -> ACAAACGGTTC
GACAATCAGCC -> ACAATCAGCCT
GACAGGAATCG -> ACAGGAATCGC
GACAGGCTATG -> ACAGGCTATGG
GACAGTATATT -> ACAGTATATTG
GACAGTCTAAT -> ACAGTCTAATA
GACAGTGTAAA -> ACAGTGTAAAC
GACCAAGAAAT -> ACCAAGAAATT
GACCATTCAAA -> ACCATTCAAAG
GACCCCGATCG -> ACCCCGATCGT
GACCCGATTGG -> ACCCGATTGGG
GACCCTTCGAC -> ACCCTTCGACC
GACCTAGGTTC -> ACCTAGGTTCG
GACCTTCCCGA -> ACCTTCCCGAA
GACGATGTAGG -> ACGATGTAGGT
GACGATGTCTG -> ACGATGTCTGG
GACGGATGCAA -> ACGGATGCAAA
GACGGGCACTA -> ACGGGCACTAC
GACGTCATCGC -> ACGTCATCGCC
GACGTGTACAG -> ACGTGTACAGA
GACGTTAGCAA -> ACGTTAGCAAA
GACTACTGGCG -> ACTACTGGCGC
GACTAGGCGAT -> ACTAGGCGATA
GACTAGTATAG -> ACTAGTATAGA
GACTATCGACC -> ACTATCGACCA
GACTCACACTC -> ACTCACACTCC
GACTCAGCTGG -> ACTCAGCTGGA
GACTCCCTCTG -> ACTCCCTCTGC
GACTCGTAGCT -> ACTCGTAGCTC
GACTCGTGCGC -> ACTCGTGCGCT
GACTGAGAACA -> ACTGAGAACAG
GACTGCGAGGA -> ACTGCGAGGAG
GACTTGAAGGG -> ACTTGAAGGGT
GACTTGACCCG -> ACTTGACCCGA
GAGAACAGAAT -> AGAACAGAATT
GAGAAGTGAGG -> AGAAGTGAGGT
GAGACGTCATC -> AGACGTCATCG
GAGATACGCAG -> AGATACGCAGC
GAGATCTTGTA -> AGATCTTGTAG
GAGATGAGCAG -> AGATGAGCAGC
GAGATGCCAGA -> AGATGCCAGAG
GAGCAGCAAGG -> AGCAGCAAGGC
GAGCCAGCTTA -> AGCCAGCTTAT
GAGCCCAGGTT -> AGCCCAGGTTG
GAGCGAGTTAC -> AGCGAGTTACG
GAGCGCTCCCC -> AGCGCTCCCCA
GAGCGTACCTC -> AGCGTACCTCC
GAGCTTGCTGA -> AGCTTGCTGAC
GAGGAGGATCA -> AGGAGGATCAG
GAGGATCAGGC -> AGGATCAGGCG
GAGGCCAGGGT -> AGGCCAGGGTT
GAGGCTTCGCT -> AGGCTTCGCTA
GAGGTCCGTAC -> AGGTCCGTACG
GAGGTGCTAAG -> AGGTGCTAAGT
GAGGTGTCCCA -> AGGTGTCCCAC
GAGTACATCGC -> AGTACATCGCT
GAGTACCGTCG -> AGTACCGTCGG
GAGTATTACTA -> AGTATTACTAT
GAGTGATCCTG -> AGTGATCCTGT
GAGTTACGAGG -> AGTTACGAGGC
GAGTTCAGCCT -> AGTTCAGCCTG
GAGTTGGATGA -> AGTTGGATGAT
GATAAACTCCT -> ATAAACTCCTC
GATAATCATGA -> ATAATCATGAT
GATACACTAGG -> ATACACTAGGC
GATACCACTCT -> ATACCACTCTT
GATACGCAGCC -> ATACGCAGCCT
GATACGTAGTT -> ATACGTAGTTC
GATACTACTGC -> ATACTACTGCG
GATAGAAGAGC -> ATAGAAGAGCT
GATAGCCAGGC -> ATAGCCAGGCT
GATAGTACAGA -> ATAGTACAGAC
GATATAAGCCC -> ATATAAGCCCC
GATCACTACAA -> ATCACTACAAT
GATCAGACAGT -> ATCAGACAGTG
GATCAGCTTGG -> ATCAGCTTGGT
GATCAGGCGGT -> ATCAGGCGGTG
GATCCTGTGGC -> ATCCTGTGGCA
GATCGCTGATC -> ATCGCTGATCG
GATCGCTGTCC -> ATCGCTGTCCT
GATCGGGAACG -> ATCGGGAACGC
GATCGTCCTGC -> ATCGTCCTGCT
GATCTCATCAT -> ATCTCATCATT
GATCTCCACAT -> ATCTCCACATG
GATCTTCAGTC -> ATCTTCAGTCG
GATCTTGTAGT -> ATCTTGTAGTT
GATGACGGGCA -> ATGACGGGCAC
GATGAGCAGCA -> ATGAGCAGCAA
GATGAGCCAGC -> ATGAGCCAGCT
GATGATACTAC -> ATGATACTACT
GATGATTTCCA -> ATGATTTCCAG
GATGCAAAGAT -> ATGCAAAGATC
GATGCCAGAGC -> ATGCCAGAGCG
GATGTAGGTAG -> ATGTAGGTAGA
GATGTATCGGT -> ATGTATCGGTT
GATGTCTGGCT -> ATGTCTGGCTT
GATTATGTCGT -> ATTATGTCGTA
GATTGATTGGT -> ATTGATTGGTT
GATTGGGAGGC -> ATTGGGAGGCT
GATTGGTTCGA -> ATTGGTTCGAA
GATTTCCAGCC -> ATTTCCAGCCG
GATTTCTACTT -> ATTTCTACTTC
GCAAAAAATCT -> CAAAAAATCTG
GCAAAATTGGC -> CAAAATTGGCC
GCAAACATAGC -> CAAACATAGCC
GCAAAGATCTC -> CAAAGATCTCC
GCAACCACAAC -> CAACCACAACG
GCAAGAAAGGG -> CAAGAAAGGGA
GCAAGATCGCT -> CAAGATCGCTG
GCAAGGCAGGT -> CAAGGCAGGTG
GCAATCTGTTC -> CAATCTGTTCA
GCACATTGATA -> CACATTGATAC
GCACCGGGCAT -> CACCGGGCATC
GCACTAACCTA -> CACTAACCTAT
GCACTAATTAC -> CACTAATTACC
GCACTACTAGA -> CACTACTAGAA
GCAGCAAGGCA -> CAGCAAGGCAG
GCAGCCTCTGG -> CAGCCTCTGGG
GCAGGTCTTCG -> CAGGTCTTCGT
GCAGGTGATTT -> CAGGTGATTTC
GCAGGTTAGAT -> CAGGTTAGATA
GCAGTAATCAC -> CAGTAATCACG
GCAGTGGACCA -> CAGTGGACCAT
GCATAAAGGAA -> CATAAAGGAAC
GCATAATTTGC -> CATAATTTGCT
GCATACCCCAA -> CATACCCCAAG
GCATCAGAAGT -> CATCAGAAGTT
GCATCGCATCT -> CATCGCATCTT
GCATCTGCCCG -> CATCTGCCCGT
GCATCTTTTCT -> CATCTTTTCTC
GCATTAAGTAG -> CATTAAGTAGC
GCATTGTCCTA -> CATTGTCCTAA
GCCACGCCCGC -> CCACGCCCGCT
GCCAGAGCGTA -> CCAGAGCGTAC
GCCAGCCCGTA -> CCAGCCCGTAT
GCCAGCTTATT -> CCAGCTTATTC
GCCAGGATCAG -> CCAGGATCAGA
GCCAGGCTACT -> CCAGGCTACTT
GCCAGGGTTAG -> CCAGGGTTAGA
GCCATATCTCG -> CCATATCTCGG
GCCATCCGACT -> CCATCCGACTT
GCCATCCGTCT -> CCATCCGTCTG
GCCCAGGTTGG -> CCCAGGTTGGC
GCCCCGTGGTT -> CCCCGTGGTTG
GCCCCTCCAGG -> CCCCTCCAGGC
GCCCGCTGACT -> CCCGCTGACTC
GCCCGTAGTGA -> CCCGTAGTGAA
GCCCGTATAGC -> CCCGTATAGCG
GCCCTTACCAG -> CCCTTACCAGA
GCCGACGTGTA -> CCGACGTGTAC
GCCGACTATCG -> CCGACTATCGA
GCCGATACGTA -> CCGATACGTAG
GCCGCATTGTC -> CCGCATTGTCC
GCCGCCGCATT -> CCGCCGCATTG
GCCGTCACTGA -> CCGTCACTGAG
GCCTAGTCATA -> CCTAGTCATAT
GCCTATATCAC -> CCTATATCACG
GCCTCTGGGCC -> CCTCTGGGCCC
GCCTGCGGAGG -> CCTGCGGAGGT
GCCTGCTTAGC -> CCTGCTTAGCG
GCCTGGGTGTG -> CCTGGGTGTGA
GCCTTCCACAC -> CCTTCCACACG
GCGACTCGTAG -> CGACTCGTAGC
GCGAGGAGGAT -> CGAGGAGGATC
GCGAGTACCGT -> CGAGTACCGTC
GCGAGTTACGA -> CGAGTTACGAG
GCGATAATCAT -> CGATAATCATG
GCGCAATCTGT -> CGCAATCTGTT
GCGCACCGGGC -> CGCACCGGGCA
GCGCCAGGATC -> CGCCAGGATCA
GCGCCGCCGCA -> CGCCGCCGCAT
GCGCGCCGCCG -> CGCGCCGCCGC
GCGCGGTCCCG -> CGCGGTCCCGA
GCGCTCCCCAT -> CGCTCCCCATT
GCGCTCTAGGC -> CGCTCTAGGCA
GCGCTCTAGTT -> CGCTCTAGTTT
GCGCTGCCGAC -> CGCTGCCGACT
GCGGAGGTGCT -> CGGAGGTGCTA
GCGGGCCACGC -> CGGGCCACGCC
GCGGGGACTTG -> CGGGGACTTGA
GCGGTCCCGAA -> CGGTCCCGAAC
GCGGTGCACAT -> CGGTGCACATT
GCGTAAAGCAT -> CGTAAAGCATA
GCGTAAGACTA -> CGTAAGACTAG
GCGTACCTCCC -> CGTACCTCCCT
GCGTCTTATAG -> CGTCTTATAGG
GCGTGACTCAG -> CGTGACTCAGC
GCGTGAGATCT -> CGTGAGATCTT
GCGTTCGGTTC -> CGTTCGGTTCA
GCTAAAAAGAA -> CTAAAAAGAAG
GCTAAAGATAC -> CTAAAGATACC
GCTAAGTTGGG -> CTAAGTTGGGG
GCTACTTACCG -> CTACTTACCGA
GCTATACAGCG -> CTATACAGCGT
GCTATGGGTTA -> CTATGGGTTAG
GCTATGTGTAT -> CTATGTGTATA
GCTCAACCATT -> CTCAACCATTT
GCTCACTCGTA -> CTCACTCGTAA
GCTCCAGTACT -> CTCCAGTACTG
GCTCCCCATTC -> CTCCCCATTCG
GCTCCGATATA -> CTCCGATATAA
GCTCGGAAATC -> CTCGGAAATCG
GCTCGTAAAGA -> CTCGTAAAGAC
GCTCTAGGCAT -> CTCTAGGCATA
GCTCTAGTTTA -> CTCTAGTTTAC
GCTGACTCACA -> CTGACTCACAC
GCTGACTGAGA -> CTGACTGAGAA
GCTGATCGGGA -> CTGATCGGGAA
GCTGCCGACTA -> CTGCCGACTAT
GCTGGACAGTA -> CTGGACAGTAT
GCTGGGAAGAC -> CTGGGAAGACT
GCTGGTCGCGC -> CTGGTCGCGCT
GCTGTCCTCGT -> CTGTCCTCGTA
GCTGTCTTGTC -> CTGTCTTGTCG
GCTTAGCAAAA -> CTTAGCAAAAA
GCTTAGCGCGC -> CTTAGCGCGCC
GCTTATTCGAC -> CTTATTCGACA
GCTTCAGCTGT -> CTTCAGCTGTC
GCTTCATGACA -> CTTCATGACAG
GCTTCATTTCT -> CTTCATTTCTT
GCTTCGCTAAA -> CTTCGCTAAAG
GCTTGAGTATT -> CTTGAGTATTA
GCTTGCTGACT -> CTTGCTGACTG
GCTTGGCAACC -> CTTGGCAACCA
GCTTGGTTGTA -> CTTGGTTGTAG
GCTTTGTGTTA -> CTTTGTGTTAT
GGAAAAGATCT -> GAAAAGATCTC
GGAAATCGATC -> GAAATCGATCA
GGAACGCATCA -> GAACGCATCAG
GGAACGGATGA -> GAACGGATGAC
GGAACGTACCC -> GAACGTACCCC
GGAAGACTCGT -> GAAGACTCGTG
GGAATCGCATT -> GAATCGCATTA
GGAATGTGAAT -> GAATGTGAATG
GGACAGGCTAT -> GACAGGCTATG
GGACAGTATAT -> GACAGTATATT
GGACCATTCAA -> GACCATTCAAA
GGACCCCGATC -> GACCCCGATCG
GGACGTTAGCA -> GACGTTAGCAA
GGACTGCGAGG -> GACTGCGAGGA
GGACTTGAAGG -> GACTTGAAGGG
GGAGATACGCA -> GAGATACGCAG
GGAGGATCAGG -> GAGGATCAGGC
GGAGGCTTCGC -> GAGGCTTCGCT
GGAGGTGCTAA -> GAGGTGCTAAG
GGATCAGACAG -> GATCAGACAGT
GGATCAGGCGG -> GATCAGGCGGT
GGATGACGGGC -> GATGACGGGCA
GGATGATACTA -> GATGATACTAC
GGATGCAAAGA -> GATGCAAAGAT
GGATTGATTGG -> GATTGATTGGT
GGCAACCACAA -> GCAACCACAAC
GGCAAGATCGC -> GCAAGATCGCT
GGCACTACTAG -> GCACTACTAGA
GGCAGGTCTTC -> GCAGGTCTTCG
GGCAGGTGATT -> GCAGGTGATTT
GGCAGGTTAGA -> GCAGGTTAGAT
GGCAGTAATCA -> GCAGTAATCAC
GGCAGTGGACC -> GCAGTGGACCA
GGCATAAAGGA -> GCATAAAGGAA
GGCATCTGCCC -> GCATCTGCCCG
GGCCACGCCCG -> GCCACGCCCGC
GGCCAGCCCGT -> GCCAGCCCGTA
GGCCAGGGTTA -> GCCAGGGTTAG
GGCCATATCTC -> GCCATATCTCG
GGCCATCCGTC -> GCCATCCGTCT
GGCCCTTACCA -> GCCCTTACCAG
GGCCGACGTGT -> GCCGACGTGTA
GGCCGATACGT -> GCCGATACGTA
GGCCTGCTTAG -> GCCTGCTTAGC
GGCGATAATCA -> GCGATAATCAT
GGCGCAATCTG -> GCGCAATCTGT
GGCGGGCCACG -> GCGGGCCACGC
GGCGGGGACTT -> GCGGGGACTTG
GGCGGTGCACA -> GCGGTGCACAT
GGCTACTTACC -> GCTACTTACCG
GGCTATACAGC -> GCTATACAGCG
GGCTATGGGTT -> GCTATGGGTTA
GGCTTCAGCTG -> GCTTCAGCTGT
GGCTTCGCTAA -> GCTTCGCTAAA
GGGAAAAGATC -> GGAAAAGATCT
GGGAACGCATC -> GGAACGCATCA
GGGAACGGATG -> GGAACGGATGA
GGGAAGACTCG -> GGAAGACTCGT
GGGACTTGAAG -> GGACTTGAAGG
GGGAGGCTTCG -> GGAGGCTTCGC
GGGCACTACTA -> GGCACTACTAG
GGGCAGGTTAG -> GGCAGGTTAGA
GGGCATCTGCC -> GGCATCTGCCC
GGGCCACGCCC -> GGCCACGCCCG
GGGCCCTTACC -> GGCCCTTACCA
GGGCCGACGTG -> GGCCGACGTGT
GGGGAACGGAT -> GGGAACGGATG
GGGGACTTGAA -> GGGACTTGAAG
GGGGCCGACGT -> GGGCCGACGTG
GGGGGAACGGA -> GGGGAACGGAT
GGGGGCCGACG -> GGGGCCGACGT
GGGTATATAAA -> GGTATATAAAT
GGGTCCCGCTA -> GGTCCCGCTAT
GGGTGTGAAGT -> GGTGTGAAGTT
GGGTTAGATCG -> GGTTAGATCGC
GGGTTAGATTA -> GGTTAGATTAT
GGTACTTGTTA -> GTACTTGTTAA
GGTAGATAAAC -> GTAGATAAACT
GGTATAGAGTG -> GTATAGAGTGA
GGTATATAAAT -> GTATATAAATA
GGTATGACTAC -> GTATGACTACT
GGTATTTTGTT -> GTATTTTGTTC
GGTCCCCGCTC -> GTCCCCGCTCC
GGTCCCGAACA -> GTCCCGAACAC
GGTCCCGCTAT -> GTCCCGCTATG
GGTCCGTACGG -> GTCCGTACGGC
GGTCGCGCTCT -> GTCGCGCTCTA
GGTCTTCGTAG -> GTCTTCGTAGA
GGTGAGGTCCG -> GTGAGGTCCGT
GGTGATTTCTA -> GTGATTTCTAC
GGTGCACATTG -> GTGCACATTGA
GGTGCTAAGTT -> GTGCTAAGTTG
GGTGTCCCACA -> GTGTCCCACAT
GGTGTGAAGTT -> GTGTGAAGTTG
GGTGTTGTAAA -> GTGTTGTAAAT
GGTTAGATAGT -> GTTAGATAGTA
GGTTAGATCGC -> GTTAGATCGCT
GGTTAGATTAT -> GTTAGATTATG
GGTTCATAGCG -> GTTCATAGCGT
GGTTCGAACGA -> GTTCGAACGAT
GGTTCGTTTGG -> GTTCGTTTGGC
GGTTCTGCGCA -> GTTCTGCGCAC
GGTTGAGCGCT -> GTTGAGCGCTC
GGTTGCTTCAT -> GTTGCTTCATT
GGTTGGCCGAT -> GTTGGCCGATA
GGTTGTAGAGA -> GTTGTAGAGAC
GGTTGTCCGGT -> GTTGTCCGGTG
GGTTGTGGACT -> GTTGTGGACTG
GTAAACACTAC -> TAAACACTACG
GTAAAGACTCC -> TAAAGACTCCC
GTAAAGCATAA -> TAAAGCATAAT
GTAAATCGGTA -> TAAATCGGTAT
GTAAATTTGTC -> TAAATTTGTCC
GTAACAGATGT -> TAACAGATGTA
GTAAGACTAGT -> TAAGACTAGTA
GTAATCACGGA -> TAATCACGGAC
GTACAGACGAT -> TACAGACGATG
GTACAGAGTTC -> TACAGAGTTCA
GTACATCGCTT -> TACATCGCTTC
GTACCCCGGGC -> TACCCCGGGCA
GTACCGTCGGT -> TACCGTCGGTT
GTACCTCCCTT -> TACCTCCCTTG
GTACGGCAGGT -> TACGGCAGGTC
GTACTGACTAG -> TACTGACTAGG
GTACTTGTTAA -> TACTTGTTAAA
GTAGAGACGTC -> TAGAGACGTCA
GTAGAGATGCC -> TAGAGATGCCA
GTAGATAAACT -> TAGATAAACTC
GTAGATGATTT -> TAGATGATTTC
GTAGCGCCAGG -> TAGCGCCAGGA
GTAGCTCGGAA -> TAGCTCGGAAA
GTAGCTGGGAA -> TAGCTGGGAAG
GTAGGTAGATA -> TAGGTAGATAA
GTAGGTATAGA -> TAGGTATAGAG
GTAGTGAAGGA -> TAGTGAAGGAC
GTAGTTCACAG -> TAGTTCACAGA
GTAGTTCTTCG -> TAGTTCTTCGC
GTATACTGGAG -> TATACTGGAGA
GTATAGAGTGA -> TATAGAGTGAT
GTATAGATCAC -> TATAGATCACT
GTATAGCGACT -> TATAGCGACTC
GTATATAAATA -> TATATAAATAT
GTATATTGCTA -> TATATTGCTAA
GTATATTTATT -> TATATTTATTT
GTATCAAGTCT -> TATCAAGTCTT
GTATCGGTTCT -> TATCGGTTCTG
GTATGACTACT -> TATGACTACTG
GTATTACTATC -> TATTACTATCA
GTATTTAGTAT -> TATTTAGTATC
GTATTTTGTTC -> TATTTTGTTCG
GTCACCCAAAT -> TCACCCAAATT
GTCACTGAGTA -> TCACTGAGTAC
GTCATATTCAG -> TCATATTCAGT
GTCATCGCCCC -> TCATCGCCCCT
GTCCAGAGTTG -> TCCAGAGTTGG
GTCCCACATTC -> TCCCACATTCA
GTCCCCGCTCC -> TCCCCGCTCCA
GTCCCGAACAC -> TCCCGAACACT
GTCCCGCTATG -> TCCCGCTATGT
GTCCGGTGTTG -> TCCGGTGTTGT
GTCCGTACGGC -> TCCGTACGGCA
GTCCTAATAGC -> TCCTAATAGCT
GTCCTCGTAAA -> TCCTCGTAAAT
GTCCTGAGAAG -> TCCTGAGAAGT
GTCCTGCTTTG -> TCCTGCTTTGT
GTCGAGCCCAG -> TCGAGCCCAGG
GTCGCAAACAT -> TCGCAAACATA
GTCGCGCTCTA -> TCGCGCTCTAG
GTCGGTTGTGG -> TCGGTTGTGGA
GTCGTAGATGA -> TCGTAGATGAT
GTCGTAGGTAT -> TCGTAGGTATA
GTCTAATAAGC -> TCTAATAAGCT
GTCTGCTCACT -> TCTGCTCACTC
GTCTGGCTTCA -> TCTGGCTTCAG
GTCTTATAGGT -> TCTTATAGGTC
GTCTTCGTAGA -> TCTTCGTAGAG
GTCTTGTCGAG -> TCTTGTCGAGC
GTCTTTTATTT -> TCTTTTATTTT
GTGAAGGACAG -> TGAAGGACAGG
GTGAAGTTGCG -> TGAAGTTGCGT
GTGAATGCGTG -> TGAATGCGTGA
GTGACTCAGCT -> TGACTCAGCTG
GTGAGATCTTG -> TGAGATCTTGT
GTGAGGTCCGT -> TGAGGTCCGTA
GTGAGGTGTCC -> TGAGGTGTCCC
GTGATAGAAGA -> TGATAGAAGAG
GTGATCCTGTG -> TGATCCTGTGG
GTGATTTCTAC -> TGATTTCTACT
GTGCAAGAAAG -> TGCAAGAAAGG
GTGCACATTGA -> TGCACATTGAT
GTGCGCTCTAG -> TGCGCTCTAGG
GTGCGTTCGGT -> TGCGTTCGGTT
GTGCTAAGTTG -> TGCTAAGTTGG
GTGGACCATTC -> TGGACCATTCA
GTGGACTGCGA -> TGGACTGCGAG
GTGGCAAGATC -> TGGCAAGATCG
GTGGTTGCTTC -> TGGTTGCTTCA
GTGTAAACACT -> TGTAAACACTA
GTGTACAGAGT -> TGTACAGAGTT
GTGTATATTTA -> TGTATATTTAT
GTGTCCCACAT -> TGTCCCACATT
GTGTGAAGTTG -> TGTGAAGTTGC
GTGTTATCCCC -> TGTTATCCCCC
GTGTTGTAAAT -> TGTTGTAAATT
GTTAAATAGAC -> TTAAATAGACG
GTTACATCTTG -> TTACATCTTGG
GTTACGAGGCC -> TTACGAGGCCA
GTTAGATAGTA -> TTAGATAGTAC
GTTAGATCGCT -> TTAGATCGCTG
GTTAGATTATG -> TTAGATTATGT
GTTAGCAAAAT -> TTAGCAAAATT
GTTATCCCCCT -> TTATCCCCCTG
GTTCACAGACA -> TTCACAGACAA
GTTCAGCCATC -> TTCAGCCATCC
GTTCAGCCTGC -> TTCAGCCTGCG
GTTCATAGCGT -> TTCATAGCGTA
GTTCGAACGAT -> TTCGAACGATG
GTTCGGGTCCC -> TTCGGGTCCCG
GTTCGGTTCAT -> TTCGGTTCATA
GTTCGTTTGGC -> TTCGTTTGGCC
GTTCTGCGCAC -> TTCTGCGCACC
GTTCTTCGCCT -> TTCTTCGCCTA
GTTCTTGGTTG -> TTCTTGGTTGA
GTTGAGCGCTC -> TTGAGCGCTCC
GTTGCGCTGCC -> TTGCGCTGCCG
GTTGCGTAAGA -> TTGCGTAAGAC
GTTGCTTCATT -> TTGCTTCATTT
GTTGGATGATA -> TTGGATGATAC
GTTGGCCGATA -> TTGGCCGATAC
GTTGGGGGAAC -> TTGGGGGAACG
GTTGTAAATTT -> TTGTAAATTTG
GTTGTAGAGAC -> TTGTAGAGACG
GTTGTCCGGTG -> TTGTCCGGTGT
GTTGTGGACTG -> TTGTGGACTGC
GTTTACGGCGG -> TTTACGGCGGG
GTTTGGCCAGC -> TTTGGCCAGCC
TAAAAAGAAGT -> AAAAAGAAGTG
TAAACACTACG -> AAACACTACGT
TAAACTCCTCC -> AAACTCCTCCG
TAAAGACTCCC -> AAAGACTCCCT
TAAAGATACCA -> AAAGATACCAC
TAAAGCATAAT -> AAAGCATAATT
TAAAGGAACGT -> AAAGGAACGTA
TAAATAGACGA -> AAATAGACGAT
TAAATATCGGT -> AAATATCGGTG
TAAATATGACA -> AAATATGACAA
TAAATCGGTAT -> AAATCGGTATT
TAAATTTGTCC -> AAATTTGTCCA
TAACAGATGTA -> AACAGATGTAT
TAACATATCCG -> AACATATCCGG
TAACCTATAAA -> AACCTATAAAT
TAAGACTAGTA -> AAGACTAGTAT
TAAGCCCCGTG -> AAGCCCCGTGG
TAAGCTCGTAA -> AAGCTCGTAAA
TAAGTAGCGCC -> AAGTAGCGCCA
TAAGTTGGGGG -> AAGTTGGGGGA
TAATAACATAT -> AATAACATATC
TAATAAGCTCG -> AATAAGCTCGT
TAATAATACAG -> AATAATACAGG
TAATACAGGTA -> AATACAGGTAC
TAATAGCTTAG -> AATAGCTTAGC
TAATCACGGAC -> AATCACGGACG
TAATCATGATC -> AATCATGATCT
TAATGTTCTTG -> AATGTTCTTGG
TAATTACCTGC -> AATTACCTGCG
TAATTTGCTGG -> AATTTGCTGGT
TACAAGTATTT -> ACAAGTATTTA
TACAATTAATA -> ACAATTAATAA
TACACTAGGCT -> ACACTAGGCTA
TACAGACGATG -> ACAGACGATGT
TACAGAGTTCA -> ACAGAGTTCAG
TACAGCGTGAG -> ACAGCGTGAGA
TACAGGTACTT -> ACAGGTACTTG
TACATCGCTTC -> ACATCGCTTCA
TACATCTTGGC -> ACATCTTGGCC
TACCACTCTTG -> ACCACTCTTGC
TACCAGATAGC -> ACCAGATAGCC
TACCCCAAGGC -> ACCCCAAGGCG
TACCCCGGGCA -> ACCCCGGGCAG
TACCGACAAAA -> ACCGACAAAAG
TACCGTCGGTT -> ACCGTCGGTTG
TACCTCCCTTG -> ACCTCCCTTGG
TACCTGAGCGA -> ACCTGAGCGAG
TACCTGCGTCT -> ACCTGCGTCTT
TACGAGGCCAG -> ACGAGGCCAGG
TACGCAGCCTC -> ACGCAGCCTCT
TACGGCAGGTC -> ACGGCAGGTCT
TACGGCGGGCC -> ACGGCGGGCCA
TACGTAGTTCA -> ACGTAGTTCAC
TACGTCCTGAG -> ACGTCCTGAGA
TACGTTACATC -> ACGTTACATCT
TACTACTGCGA -> ACTACTGCGAG
TACTAGAAGAG -> ACTAGAAGAGA
TACTATCAGGC -> ACTATCAGGCA
TACTGACTAGG -> ACTGACTAGGC
TACTGCGAGTA -> ACTGCGAGTAC
TACTGGAGATA -> ACTGGAGATAC
TACTGGCGCAA -> ACTGGCGCAAT
TACTTACCGAC -> ACTTACCGACA
TACTTCATTAA -> ACTTCATTAAT
TACTTGTTAAA -> ACTTGTTAAAT
TAGAAGAGATG -> AGAAGAGATGA
TAGAAGAGCTT -> AGAAGAGCTTG
TAGACGATGTC -> AGACGATGTCT
TAGAGACGTCA -> AGAGACGTCAT
TAGAGATGCCA -> AGAGATGCCAG
TAGAGTGATCC -> AGAGTGATCCT
TAGATAAACTC -> AGATAAACTCC
TAGATAGTACA -> AGATAGTACAG
TAGATCACTAC -> AGATCACTACA
TAGATCGCTGA -> AGATCGCTGAT
TAGATGATTTC -> AGATGATTTCC
TAGATTATGTC -> AGATTATGTCG
TAGCAAAAAAT -> AGCAAAAAATC
TAGCAAAATTG -> AGCAAAATTGG
TAGCCAGGCTA -> AGCCAGGCTAC
TAGCCTGGGTG -> AGCCTGGGTGT
TAGCGACTCGT -> AGCGACTCGTA
TAGCGCCAGGA -> AGCGCCAGGAT
TAGCGCGCCGC -> AGCGCGCCGCC
TAGCGTAAAGC -> AGCGTAAAGCA
TAGCTCGGAAA -> AGCTCGGAAAT
TAGCTGGGAAG -> AGCTGGGAAGA
TAGCTTAGCAA -> AGCTTAGCAAA
TAGGCATAAAG -> AGGCATAAAGG
TAGGCGATAAT -> AGGCGATAATC
TAGGCTATACA -> AGGCTATACAG
TAGGTAGATAA -> AGGTAGATAAA
TAGGTATAGAG -> AGGTATAGAGT
TAGGTCCCCGC -> AGGTCCCCGCT
TAGGTTCGTTT -> AGGTTCGTTTG
TAGTACAGACG -> AGTACAGACGA
TAGTATAGATC -> AGTATAGATCA
TAGTATCAAGT -> AGTATCAAGTC
TAGTCATATTC -> AGTCATATTCA
TAGTGAAGGAC -> AGTGAAGGACA
TAGTTCACAGA -> AGTTCACAGAC
TAGTTCTTCGC -> AGTTCTTCGCC
TAGTTTACGGC -> AGTTTACGGCG
TATAAATATCG -> ATAAATATCGG
TATAAATATGA -> ATAAATATGAC
TATAAGCCCCG -> ATAAGCCCCGT
TATACAGCGTG -> ATACAGCGTGA
TATACTGGAGA -> ATACTGGAGAT
TATAGAGTGAT -> ATAGAGTGATC
TATAGATCACT -> ATAGATCACTA
TATAGCGACTC -> ATAGCGACTCG
TATAGGTCCCC -> ATAGGTCCCCG
TATATAAATAT -> ATATAAATATG
TATATCACGAA -> ATATCACGAAG
TATATTGCTAA -> ATATTGCTAAA
TATATTTATTT -> ATATTTATTTG
TATCAAGTCTT -> ATCAAGTCTTT
TATCACGAAGC -> ATCACGAAGCT
TATCAGGCAGT -> ATCAGGCAGTA
TATCCCCCTGT -> ATCCCCCTGTC
TATCCGGTTGT -> ATCCGGTTGTC
TATCGACCAAG -> ATCGACCAAGA
TATCGGTGAGG -> ATCGGTGAGGT
TATCGGTTCTG -> ATCGGTTCTGC
TATCTCGGAAT -> ATCTCGGAATG
TATGACAAACG -> ATGACAAACGG
TATGACTACTG -> ATGACTACTGG
TATGGGTTAGA -> ATGGGTTAGAT
TATGTCGTAGA -> ATGTCGTAGAT
TATGTGTATAT -> ATGTGTATATT
TATTACTATCA -> ATTACTATCAG
TATTCAGTGCA -> ATTCAGTGCAA
TATTCGACAGT -> ATTCGACAGTC
TATTGCTAAAA -> ATTGCTAAAAA
TATTTAGTATC -> ATTTAGTATCA
TATTTATTTGC -> ATTTATTTGCC
TATTTGCCTAG -> ATTTGCCTAGT
TATTTTACCTG -> ATTTTACCTGA
TATTTTGTTCG -> ATTTTGTTCGG
TCAAAGACCTT -> CAAAGACCTTC
TCAACCATTTT -> CAACCATTTTC
TCAAGTCTTTT -> CAAGTCTTTTA
TCACACTCCTG -> CACACTCCTGC
TCACAGACAAT -> CACAGACAATC
TCACCCAAATT -> CACCCAAATTG
TCACGAAGCTT -> CACGAAGCTTG
TCACGGACGTT -> CACGGACGTTA
TCACTACAATT -> CACTACAATTA
TCACTCGTAAC -> CACTCGTAACA
TCACTGAGTAC -> CACTGAGTACA
TCAGAAGTTGC -> CAGAAGTTGCG
TCAGACAGTGT -> CAGACAGTGTA
TCAGCCATCCG -> CAGCCATCCGA
TCAGCCTGCGG -> CAGCCTGCGGA
TCAGCCTTCCA -> CAGCCTTCCAC
TCAGCTGGACA -> CAGCTGGACAG
TCAGCTGTCTT -> CAGCTGTCTTG
TCAGCTTGGTT -> CAGCTTGGTTG
TCAGGCAGTAA -> CAGGCAGTAAT
TCAGGCGGTGC -> CAGGCGGTGCA
TCAGTCGTAGG -> CAGTCGTAGGT
TCAGTGCAAGA -> CAGTGCAAGAA
TCATAGCGTAA -> CATAGCGTAAA
TCATATTCAGT -> CATATTCAGTG
TCATCATTACG -> CATCATTACGT
TCATCGCCCCT -> CATCGCCCCTC
TCATGACAGGA -> CATGACAGGAA
TCATGACCCTT -> CATGACCCTTC
TCATGATCTTC -> CATGATCTTCA
TCATTAATGTT -> CATTAATGTTC
TCATTACGTCC -> CATTACGTCCT
TCATTTCTTCT -> CATTTCTTCTA
TCCACACGAAC -> CCACACGAACG
TCCACATGTCG -> CCACATGTCGC
TCCAGAGTTGG -> CCAGAGTTGGA
TCCAGCCGTCA -> CCAGCCGTCAC
TCCAGGCCTGC -> CCAGGCCTGCT
TCCAGTACTGA -> CCAGTACTGAC
TCCCACATTCA -> CCCACATTCAT
TCCCCATTCGC -> CCCCATTCGCT
TCCCCATTCGG -> CCCCATTCGGA
TCCCCCTGTCA -> CCCCCTGTCAC
TCCCCGCTCCA -> CCCCGCTCCAG
TCCCGAACACT -> CCCGAACACTT
TCCCGAAGACG -> CCCGAAGACGG
TCCCGCTATGT -> CCCGCTATGTG
TCCCTCTGCTT -> CCCTCTGCTTG
TCCCTTGGACC -> CCCTTGGACCC
TCCGACTTGAC -> CCGACTTGACC
TCCGATATAAG -> CCGATATAAGC
TCCGCACTAAC -> CCGCACTAACC
TCCGGCAGTGG -> CCGGCAGTGGA
TCCGGTGTTGT -> CCGGTGTTGTA
TCCGGTTGTCC -> CCGGTTGTCCG
TCCGTACGGCA -> CCGTACGGCAG
TCCGTCTGCTC -> CCGTCTGCTCA
TCCTAATAGCT -> CCTAATAGCTT
TCCTACAAGTA -> CCTACAAGTAT
TCCTCCGCACT -> CCTCCGCACTA
TCCTCGTAAAT -> CCTCGTAAATC
TCCTGAGAAGT -> CCTGAGAAGTG
TCCTGCTCAAC -> CCTGCTCAACC
TCCTGCTTTGT -> CCTGCTTTGTG
TCCTGTGGCAA -> CCTGTGGCAAG
TCGAACGATGA -> CGAACGATGAG
TCGACAGTCTA -> CGACAGTCTAA
TCGACCAAGAA -> CGACCAAGAAA
TCGACCTAGGT -> CGACCTAGGTT
TCGAGCCCAGG -> CGAGCCCAGGT
TCGATCAGCTT -> CGATCAGCTTG
TCGCAAACATA -> CGCAAACATAG
TCGCATCTTTT -> CGCATCTTTTC
TCGCATTAAGT -> CGCATTAAGTA
TCGCCCCTCCA -> CGCCCCTCCAG
TCGCCTATATC -> CGCCTATATCA
TCGCGCTCTAG -> CGCGCTCTAGT
TCGCTAAAGAT -> CGCTAAAGATA
TCGCTCCGATA -> CGCTCCGATAT
TCGCTGATCGG -> CGCTGATCGGG
TCGCTGTCCTC -> CGCTGTCCTCG
TCGCTTCATGA -> CGCTTCATGAC
TCGGAAATCGA -> CGGAAATCGAT
TCGGAATGTGA -> CGGAATGTGAA
TCGGATTGATT -> CGGATTGATTG
TCGGGAACGCA -> CGGGAACGCAT
TCGGGTCCCGC -> CGGGTCCCGCT
TCGGTATTTTG -> CGGTATTTTGT
TCGGTGAGGTC -> CGGTGAGGTCC
TCGGTTCATAG -> CGGTTCATAGC
TCGGTTCTGCG -> CGGTTCTGCGC
TCGGTTGTGGA -> CGGTTGTGGAC
TCGTAAAGACT -> CGTAAAGACTC
TCGTAAATCGG -> CGTAAATCGGT
TCGTAACAGAT -> CGTAACAGATG
TCGTAGAGATG -> CGTAGAGATGC
TCGTAGATGAT -> CGTAGATGATT
TCGTAGCTCGG -> CGTAGCTCGGA
TCGTAGGTATA -> CGTAGGTATAG
TCGTCCTGCTT -> CGTCCTGCTTT
TCGTGCGCTCT -> CGTGCGCTCTA
TCGTTTGGCCA -> CGTTTGGCCAG
TCTAATAAGCT -> CTAATAAGCTC
TCTAATAATAC -> CTAATAATACA
TCTACTTCATT -> CTACTTCATTA
TCTAGGCATAA -> CTAGGCATAAA
TCTAGTTTACG -> CTAGTTTACGG
TCTCATCATTA -> CTCATCATTAC
TCTCCACATGT -> CTCCACATGTC
TCTCCCCATTC -> CTCCCCATTCG
TCTCGGAATGT -> CTCGGAATGTG
TCTGAAGCACT -> CTGAAGCACTA
TCTGCCCGTAG -> CTGCCCGTAGT
TCTGCGCACCG -> CTGCGCACCGG
TCTGCTCACTC -> CTGCTCACTCG
TCTGCTTGAGT -> CTGCTTGAGTA
TCTGGCTTCAG -> CTGGCTTCAGC
TCTGGGCCCTT -> CTGGGCCCTTA
TCTGTGATAGA -> CTGTGATAGAA
TCTGTTCAGCC -> CTGTTCAGCCA
TCTTATAGGTC -> CTTATAGGTCC
TCTTCAGTCGT -> CTTCAGTCGTA
TCTTCGCCTAT -> CTTCGCCTATA
TCTTCGTAGAG -> CTTCGTAGAGA
TCTTCTAATAA -> CTTCTAATAAT
TCTTGCATCGC -> CTTGCATCGCA
TCTTGGCCATA -> CTTGGCCATAT
TCTTGGTTGAG -> CTTGGTTGAGC
TCTTGTAGTTC -> CTTGTAGTTCT
TCTTGTCGAGC -> CTTGTCGAGCC
TCTTTTATTTT -> CTTTTATTTTA
TCTTTTCTCCC -> CTTTTCTCCCC
TGAAGCACTAA -> GAAGCACTAAT
TGAAGGACAGG -> GAAGGACAGGC
TGAAGGGTATA -> GAAGGGTATAT
TGAAGTTGCGT -> GAAGTTGCGTA
TGAATGCGTGA -> GAATGCGTGAC
TGACAAACGGT -> GACAAACGGTT
TGACAGGAATC -> GACAGGAATCG
TGACCCGATTG -> GACCCGATTGG
TGACCCTTCGA -> GACCCTTCGAC
TGACGGGCACT -> GACGGGCACTA
TGACTACTGGC -> GACTACTGGCG
TGACTAGGCGA -> GACTAGGCGAT
TGACTCACACT -> GACTCACACTC
TGACTCAGCTG -> GACTCAGCTGG
TGACTGAGAAC -> GACTGAGAACA
TGAGAACAGAA -> GAGAACAGAAT
TGAGAAGTGAG -> GAGAAGTGAGG
TGAGATCTTGT -> GAGATCTTGTA
TGAGCAGCAAG -> GAGCAGCAAGG
TGAGCCAGCTT -> GAGCCAGCTTA
TGAGCGAGTTA -> GAGCGAGTTAC
TGAGCGCTCCC -> GAGCGCTCCCC
TGAGGTCCGTA -> GAGGTCCGTAC
TGAGGTGTCCC -> GAGGTGTCCCA
TGAGTACATCG -> GAGTACATCGC
TGAGTATTACT -> GAGTATTACTA
TGATACACTAG -> GATACACTAGG
TGATACTACTG -> GATACTACTGC
TGATAGAAGAG -> GATAGAAGAGC
TGATCCTGTGG -> GATCCTGTGGC
TGATCGGGAAC -> GATCGGGAACG
TGATCTTCAGT -> GATCTTCAGTC
TGATTGGTTCG -> GATTGGTTCGA
TGATTTCCAGC -> GATTTCCAGCC
TGATTTCTACT -> GATTTCTACTT
TGCAAAGATCT -> GCAAAGATCTC
TGCAAGAAAGG -> GCAAGAAAGGG
TGCACATTGAT -> GCACATTGATA
TGCATCGCATC -> GCATCGCATCT
TGCCAGAGCGT -> GCCAGAGCGTA
TGCCCGTAGTG -> GCCCGTAGTGA
TGCCGACTATC -> GCCGACTATCG
TGCCTAGTCAT -> GCCTAGTCATA
TGCGAGGAGGA -> GCGAGGAGGAT
TGCGAGTACCG -> GCGAGTACCGT
TGCGCACCGGG -> GCGCACCGGGC
TGCGCGGTCCC -> GCGCGGTCCCG
TGCGCTCTAGG -> GCGCTCTAGGC
TGCGCTGCCGA -> GCGCTGCCGAC
TGCGGAGGTGC -> GCGGAGGTGCT
TGCGTAAGACT -> GCGTAAGACTA
TGCGTCTTATA -> GCGTCTTATAG
TGCGTGACTCA -> GCGTGACTCAG
TGCGTTCGGTT -> GCGTTCGGTTC
TGCTAAAAAGA -> GCTAAAAAGAA
TGCTAAGTTGG -> GCTAAGTTGGG
TGCTCAACCAT -> GCTCAACCATT
TGCTCACTCGT -> GCTCACTCGTA
TGCTGACTGAG -> GCTGACTGAGA
TGCTGGTCGCG -> GCTGGTCGCGC
TGCTTAGCGCG -> GCTTAGCGCGC
TGCTTCATTTC -> GCTTCATTTCT
TGCTTGAGTAT -> GCTTGAGTATT
TGCTTTGTGTT -> GCTTTGTGTTA
TGGACAGTATA -> GGACAGTATAT
TGGACCATTCA -> GGACCATTCAA
TGGACCCCGAT -> GGACCCCGATC
TGGACTGCGAG -> GGACTGCGAGG
TGGAGATACGC -> GGAGATACGCA
TGGATGATACT -> GGATGATACTA
TGGCAACCACA -> GGCAACCACAA
TGGCAAGATCG -> GGCAAGATCGC
TGGCCAGCCCG -> GGCCAGCCCGT
TGGCCATATCT -> GGCCATATCTC
TGGCCATCCGT -> GGCCATCCGTC
TGGCCGATACG -> GGCCGATACGT
TGGCGCAATCT -> GGCGCAATCTG
TGGCTTCAGCT -> GGCTTCAGCTG
TGGGAAGACTC -> GGGAAGACTCG
TGGGAGGCTTC -> GGGAGGCTTCG
TGGGCCCTTAC -> GGGCCCTTACC
TGGGGGAACGG -> GGGGGAACGGA
TGGGTGTGAAG -> GGGTGTGAAGT
TGGGTTAGATC -> GGGTTAGATCG
TGGTCGCGCTC -> GGTCGCGCTCT
TGGTTCGAACG -> GGTTCGAACGA
TGGTTGAGCGC -> GGTTGAGCGCT
TGGTTGCTTCA -> GGTTGCTTCAT
TGGTTGTAGAG -> GGTTGTAGAGA
TGTAAACACTA -> GTAAACACTAC
TGTAAATTTGT -> GTAAATTTGTC
TGTACAGAGTT -> GTACAGAGTTC
TGTAGAGACGT -> GTAGAGACGTC
TGTAGGTAGAT -> GTAGGTAGATA
TGTAGTTCTTC -> GTAGTTCTTCG
TGTATACTGGA -> GTATACTGGAG
TGTATATTTAT -> GTATATTTATT
TGTATCGGTTC -> GTATCGGTTCT
TGTCACCCAAA -> GTCACCCAAAT
TGTCCAGAGTT -> GTCCAGAGTTG
TGTCCCACATT -> GTCCCACATTC
TGTCCGGTGTT -> GTCCGGTGTTG
TGTCCTAATAG -> GTCCTAATAGC
TGTCCTCGTAA -> GTCCTCGTAAA
TGTCGAGCCCA -> GTCGAGCCCAG
TGTCGCAAACA -> GTCGCAAACAT
TGTCGTAGATG -> GTCGTAGATGA
TGTCTGGCTTC -> GTCTGGCTTCA
TGTCTTGTCGA -> GTCTTGTCGAG
TGTGAAGTTGC -> GTGAAGTTGCG
TGTGAATGCGT -> GTGAATGCGTG
TGTGATAGAAG -> GTGATAGAAGA
TGTGGACTGCG -> GTGGACTGCGA
TGTGGCAAGAT -> GTGGCAAGATC
TGTGTATATTT -> GTGTATATTTA
TGTGTTATCCC -> GTGTTATCCCC
TGTTAAATAGA -> GTTAAATAGAC
TGTTATCCCCC -> GTTATCCCCCT
TGTTCAGCCAT -> GTTCAGCCATC
TGTTCGGGTCC -> GTTCGGGTCCC
TGTTCTTGGTT -> GTTCTTGGTTG
TGTTGTAAATT -> GTTGTAAATTT
TTAAATAGACG -> TAAATAGACGA
TTAAGTAGCGC -> TAAGTAGCGCC
TTAATAACATA -> TAATAACATAT
TTAATGTTCTT -> TAATGTTCTTG
TTACATCTTGG -> TACATCTTGGC
TTACCAGATAG -> TACCAGATAGC
TTACCGACAAA -> TACCGACAAAA
TTACCTGAGCG -> TACCTGAGCGA
TTACCTGCGTC -> TACCTGCGTCT
TTACGAGGCCA -> TACGAGGCCAG
TTACGGCGGGC -> TACGGCGGGCC
TTACGTCCTGA -> TACGTCCTGAG
TTACTATCAGG -> TACTATCAGGC
TTAGATAGTAC -> TAGATAGTACA
TTAGATCGCTG -> TAGATCGCTGA
TTAGATTATGT -> TAGATTATGTC
TTAGCAAAAAA -> TAGCAAAAAAT
TTAGCAAAATT -> TAGCAAAATTG
TTAGCGCGCCG -> TAGCGCGCCGC
TTAGTATCAAG -> TAGTATCAAGT
TTATAGGTCCC -> TATAGGTCCCC
TTATCCCCCTG -> TATCCCCCTGT
TTATGTCGTAG -> TATGTCGTAGA
TTATTCGACAG -> TATTCGACAGT
TTATTTGCCTA -> TATTTGCCTAG
TTATTTTACCT -> TATTTTACCTG
TTCAAAGACCT -> TCAAAGACCTT
TTCACAGACAA -> TCACAGACAAT
TTCAGCCATCC -> TCAGCCATCCG
TTCAGCCTGCG -> TCAGCCTGCGG
TTCAGCTGTCT -> TCAGCTGTCTT
TTCAGTCGTAG -> TCAGTCGTAGG
TTCAGTGCAAG -> TCAGTGCAAGA
TTCATAGCGTA -> TCATAGCGTAA
TTCATGACAGG -> TCATGACAGGA
TTCATGACCCT -> TCATGACCCTT
TTCATTAATGT -> TCATTAATGTT
TTCATTTCTTC -> TCATTTCTTCT
TTCCACACGAA -> TCCACACGAAC
TTCCAGCCGTC -> TCCAGCCGTCA
TTCCCGAAGAC -> TCCCGAAGACG
TTCCGGCAGTG -> TCCGGCAGTGG
TTCCTACAAGT -> TCCTACAAGTA
TTCGAACGATG -> TCGAACGATGA
TTCGACAGTCT -> TCGACAGTCTA
TTCGACCTAGG -> TCGACCTAGGT
TTCGCCTATAT -> TCGCCTATATC
TTCGCTAAAGA -> TCGCTAAAGAT
TTCGCTCCGAT -> TCGCTCCGATA
TTCGGATTGAT -> TCGGATTGATT
TTCGGGTCCCG -> TCGGGTCCCGC
TTCGGTTCATA -> TCGGTTCATAG
TTCGTAGAGAT -> TCGTAGAGATG
TTCGTTTGGCC -> TCGTTTGGCCA
TTCTAATAATA -> TCTAATAATAC
TTCTACTTCAT -> TCTACTTCATT
TTCTCCCCATT -> TCTCCCCATTC
TTCTGAAGCAC -> TCTGAAGCACT
TTCTGCGCACC -> TCTGCGCACCG
TTCTTCGCCTA -> TCTTCGCCTAT
TTCTTCTAATA -> TCTTCTAATAA
TTCTTGGTTGA -> TCTTGGTTGAG
TTGAAGGGTAT -> TGAAGGGTATA
TTGACCCGATT -> TGACCCGATTG
TTGAGCGCTCC -> TGAGCGCTCCC
TTGAGTATTAC -> TGAGTATTACT
TTGATACACTA -> TGATACACTAG
TTGATTGGTTC -> TGATTGGTTCG
TTGCATCGCAT -> TGCATCGCATC
TTGCCTAGTCA -> TGCCTAGTCAT
TTGCGCGGTCC -> TGCGCGGTCCC
TTGCGCTGCCG -> TGCGCTGCCGA
TTGCGTAAGAC -> TGCGTAAGACT
TTGCTAAAAAG -> TGCTAAAAAGA
TTGCTGACTGA -> TGCTGACTGAG
TTGCTGGTCGC -> TGCTGGTCGCG
TTGCTTCATTT -> TGCTTCATTTC
TTGGACCCCGA -> TGGACCCCGAT
TTGGATGATAC -> TGGATGATACT
TTGGCAACCAC -> TGGCAACCACA
TTGGCCAGCCC -> TGGCCAGCCCG
TTGGCCATATC -> TGGCCATATCT
TTGGCCATCCG -> TGGCCATCCGT
TTGGCCGATAC -> TGGCCGATACG
TTGGGAGGCTT -> TGGGAGGCTTC
TTGGGGGAACG -> TGGGGGAACGG
TTGGTTCGAAC -> TGGTTCGAACG
TTGGTTGAGCG -> TGGTTGAGCGC
TTGGTTGTAGA -> TGGTTGTAGAG
TTGTAAATTTG -> TGTAAATTTGT
TTGTAGAGACG -> TGTAGAGACGT
TTGTAGTTCTT -> TGTAGTTCTTC
TTGTATACTGG -> TGTATACTGGA
TTGTCCAGAGT -> TGTCCAGAGTT
TTGTCCGGTGT -> TGTCCGGTGTT
TTGTCCTAATA -> TGTCCTAATAG
TTGTCGAGCCC -> TGTCGAGCCCA
TTGTGGACTGC -> TGTGGACTGCG
TTGTGTTATCC -> TGTGTTATCCC
TTGTTAAATAG -> TGTTAAATAGA
TTGTTCGGGTC -> TGTTCGGGTCC
TTTACCTGAGC -> TTACCTGAGCG
TTTACGGCGGG -> TTACGGCGGGC
TTTAGTATCAA -> TTAGTATCAAG
TTTATTTGCCT -> TTATTTGCCTA
TTTATTTTACC -> TTATTTTACCT
TTTCCAGCCGT -> TTCCAGCCGTC
TTTCTACTTCA -> TTCTACTTCAT
TTTCTCCCCAT -> TTCTCCCCATT
TTTCTGAAGCA -> TTCTGAAGCAC
TTTCTTCTAAT -> TTCTTCTAATA
TTTGCCTAGTC -> TTGCCTAGTCA
TTTGCTGGTCG -> TTGCTGGTCGC
TTTGGCCAGCC -> TTGGCCAGCCC
TTTGTCCAGAG -> TTGTCCAGAGT
TTTGTGTTATC -> TTGTGTTATCC
TTTGTTCGGGT -> TTGTTCGGGTC
TTTTACCTGAG -> TTTACCTGAGC
TTTTATTTTAC -> TTTATTTTACC
TTTTCTCCCCA -> TTTCTCCCCAT
TTTTCTGAAGC -> TTTCTGAAGCA
TTTTGTTCGGG -> TTTGTTCGGGT
