TAAGATAACACGAATTGCGCTTAA -> AAGATAACACGAATTGCGCTTAAC
TTGCTCGCTCATCCAAGGTGTCAA -> TGCTCGCTCATCCAAGGTGTCAAT
TCTCGATTGTACAAAGGTTGCCTC -> CTCGATTGTACAAAGGTTGCCTCT
TAATCTCGACCAACCTTATTATCC -> AATCTCGACCAACCTTATTATCCC
TCAGACTGCCCCAGATCCCGCCAC -> CAGACTGCCCCAGATCCCGCCACT
GACGTAGCCTCCCTTAAGTCACGG -> ACGTAGCCTCCCTTAAGTCACGGG
GCTCGGTGAGTGTCGCGGTTTGTT -> CTCGGTGAGTGTCGCGGTTTGTTC
AATCTGTTATGTCTGGCCTAACCA -> ATCTGTTATGTCTGGCCTAACCAG
TCAAATCAGCATGATCGCAGGTGG -> CAAATCAGCATGATCGCAGGTGGG
CGCTCATCCAAGGTGTCAATGTTC -> GCTCATCCAAGGTGTCAATGTTCC
AGAGCTTAGTACGTCCGCTAATCT -> GAGCTTAGTACGTCCGCTAATCTC
TTATAAGCCAGACCGAACATTACC -> TATAAGCCAGACCGAACATTACCT
CACGTCGAATATCCGTTACATGGA -> ACGTCGAATATCCGTTACATGGAT
AGGCAGGTCAAACGGTACTATGGT -> GGCAGGTCAAACGGTACTATGGTC
TCACCAATACTACAGGTCGTGGTC -> CACCAATACTACAGGTCGTGGTCC
CTCTAAAATCCTTGCACAGTTCCG -> TCTAAAATCCTTGCACAGTTCCGC
GTATCGCTTTGTTGAGCACGGAGA -> TATCGCTTTGTTGAGCACGGAGAC
TAACCGTTTCTGCAACTGACCCTC -> AACCGTTTCTGCAACTGACCCTCT
TTTGTTCTCAAAGGGCGGCTCAAC -> TTGTTCTCAAAGGGCGGCTCAACC
GTTGCCATCAATTCTGCAGGTTTT -> TTGCCATCAATTCTGCAGGTTTTA
GCATAGCAACTTTGGCGACTAAAT -> CATAGCAACTTTGGCGACTAAATC
TGACCGTTCTGGAATCGTGGAGGT -> GACCGTTCTGGAATCGTGGAGGTC
TAGGTGACGTGAAACCACGTCCTA -> AGGTGACGTGAAACCACGTCCTAT
ACGGTACTATGGTCTCGATTGTAC -> CGGTACTATGGTCTCGATTGTACA
ATCAAACGTTCGTGCCGCTGAGCA -> TCAAACGTTCGTGCCGCTGAGCAA
TAAGCATCCCTCCATTACGTCCCA -> AAGCATCCCTCCATTACGTCCCAC
AGCGCTGTCGTAGCAGCAGAATGG -> GCGCTGTCGTAGCAGCAGAATGGG
TACTACATGCCGGTTCGAGACCCT -> ACTACATGCCGGTTCGAGACCCTC
CGCGAGGTCAAAGGGGTAAAACAC -> GCGAGGTCAAAGGGGTAAAACACC
AATATCTCAGGCTAGAGGCAACAG -> ATATCTCAGGCTAGAGGCAACAGT
GGCGACTAAATCGGCACTAGTGAC -> GCGACTAAATCGGCACTAGTGACA
CGAATAATGGCGATGCACGGGTGA -> GAATAATGGCGATGCACGGGTGAC
GGTGCAGCAGTACTACACTCTCGT -> GTGCAGCAGTACTACACTCTCGTT
ATCTCTCTAAAATCCTTGCACAGT -> TCTCTCTAAAATCCTTGCACAGTT
ATCCAGGTATTTGTGTCAAATCAG -> TCCAGGTATTTGTGTCAAATCAGC
CTTCGAATAATGGCGATGCACGGG -> TTCGAATAATGGCGATGCACGGGT
CTCTGAGTTAGCCGATATGCTTAC -> TCTGAGTTAGCCGATATGCTTACA
GTCCTATAGAGCCTGATTCTAGAC -> TCCTATAGAGCCTGATTCTAGACC
GTAGCCTCCCTTAAGTCACGGGGG -> TAGCCTCCCTTAAGTCACGGGGGG
GCAGCCCTGACTCGAGCGCTGTCG -> CAGCCCTGACTCGAGCGCTGTCGT
CACACATCAAACGTTCGTGCCGCT -> ACACATCAAACGTTCGTGCCGCTG
CACCCTGATATTATTACTACATGC -> ACCCTGATATTATTACTACATGCC
AGTTTTGGAGGTAAGATAACACGA -> GTTTTGGAGGTAAGATAACACGAA
TCGATCACGCCAAGACAACACGTC -> CGATCACGCCAAGACAACACGTCG
TCTAAGCATCCCTCCATTACGTCC -> CTAAGCATCCCTCCATTACGTCCC
CGGACACTGCCGCCCGGCACGCGG -> GGACACTGCCGCCCGGCACGCGGT
GGACATCGAATCTGTTATGTCTGG -> GACATCGAATCTGTTATGTCTGGC
TGTACACCGGATCGAGCGACTCAG -> GTACACCGGATCGAGCGACTCAGA
TGGACACAGATCGATGCACGTTTC -> GGACACAGATCGATGCACGTTTCG
TATTCAGACTGCCCCAGATCCCGC -> ATTCAGACTGCCCCAGATCCCGCC
CCCCAATAGGTGACGTGAAACCAC -> CCCAATAGGTGACGTGAAACCACG
CGGCTGCAAGAACGCCTGTTGTGC -> GGCTGCAAGAACGCCTGTTGTGCC
ATCCGATCCGTCCCCAATAGGTGA -> TCCGATCCGTCCCCAATAGGTGAC
GGCCTAACCAGGATCTCTCTAAAA -> GCCTAACCAGGATCTCTCTAAAAT
GACCCTCCCTGCCTGCCTCGAGTT -> ACCCTCCCTGCCTGCCTCGAGTTG
AGCCCGCTCTCTCGCGTGGCAAAT -> GCCCGCTCTCTCGCGTGGCAAATT
GACGATGTTGCCATCAATTCTGCA -> ACGATGTTGCCATCAATTCTGCAG
AACACCCTGATATTATTACTACAT -> ACACCCTGATATTATTACTACATG
CACGAATTGCGCTTAACCGTTTCT -> ACGAATTGCGCTTAACCGTTTCTG
ATGCTTACAACTCGCACTTCGGAC -> TGCTTACAACTCGCACTTCGGACA
CGTCTAATGTTACCTCGACCATGG -> GTCTAATGTTACCTCGACCATGGA
AGTCTATAGCAAGGGCACGGATAA -> GTCTATAGCAAGGGCACGGATAAT
GTCAGATCCAGGTATTTGTGTCAA -> TCAGATCCAGGTATTTGTGTCAAA
AGGCAACAGTTTGGTATTAGGAGT -> GGCAACAGTTTGGTATTAGGAGTG
TGGAAGATGCTACCAAGGAGCCAC -> GGAAGATGCTACCAAGGAGCCACT
CTTCACTCCGCAACGGCACACACC -> TTCACTCCGCAACGGCACACACCG
ACGTCCTTCACTCCGCAACGGCAC -> CGTCCTTCACTCCGCAACGGCACA
ACTCAGATGTAAGTCTATAGCAAG -> CTCAGATGTAAGTCTATAGCAAGG
GATCTCTCTAAAATCCTTGCACAG -> ATCTCTCTAAAATCCTTGCACAGT
ATCAATTCTGCAGGTTTTAATAGT -> TCAATTCTGCAGGTTTTAATAGTG
CGCCAAGACAACACGTCGAATATC -> GCCAAGACAACACGTCGAATATCC
TTAAGTCCGACGGCTCGACCCGGT -> TAAGTCCGACGGCTCGACCCGGTA
ACACGTCGAATATCCGTTACATGG -> CACGTCGAATATCCGTTACATGGA
CAGCCCGCTCTCTCGCGTGGCAAA -> AGCCCGCTCTCTCGCGTGGCAAAT
TTTTTTACGGCCCTCATTATCGGC -> TTTTTACGGCCCTCATTATCGGCC
CGATCACGCCAAGACAACACGTCG -> GATCACGCCAAGACAACACGTCGA
TTCCGCAGATTAAATATTGCTAAA -> TCCGCAGATTAAATATTGCTAAAC
TTGTCATGTGAGGGAACAGGCAGG -> TGTCATGTGAGGGAACAGGCAGGT
TGTTCCATCGTATATCGTAGGGAA -> GTTCCATCGTATATCGTAGGGAAT
AGTTTAAGGATCCGATCCGTCCCC -> GTTTAAGGATCCGATCCGTCCCCA
TCGCAGGTGGGTGCAGCAGTACTA -> CGCAGGTGGGTGCAGCAGTACTAC
TCCATTACGTCCCACGACTTCTCA -> CCATTACGTCCCACGACTTCTCAT
GATGTAAGTCTATAGCAAGGGCAC -> ATGTAAGTCTATAGCAAGGGCACG
AATCGGCACTAGTGACAAGTGTTC -> ATCGGCACTAGTGACAAGTGTTCA
TCGGTGAGTGTCGCGGTTTGTTCT -> CGGTGAGTGTCGCGGTTTGTTCTC
TACATGCCGGTTCGAGACCCTCCC -> ACATGCCGGTTCGAGACCCTCCCT
CCTCTGTCGGCCTTACTGTTCAGA -> CTCTGTCGGCCTTACTGTTCAGAT
GAGCGCTGTCGTAGCAGCAGAATG -> AGCGCTGTCGTAGCAGCAGAATGG
ACGGGACCAGCCCGCTCTCTCGCG -> CGGGACCAGCCCGCTCTCTCGCGT
CAGACTGCCCCAGATCCCGCCACT -> AGACTGCCCCAGATCCCGCCACTA
CTGTTCAGATCGAGACGTAGCCTC -> TGTTCAGATCGAGACGTAGCCTCC
CAAAGGGCGGCTCAACCGTTTGTC -> AAAGGGCGGCTCAACCGTTTGTCT
GCTATTCAGACTGCCCCAGATCCC -> CTATTCAGACTGCCCCAGATCCCG
TACATAGCAGGACCCAATATCTAC -> ACATAGCAGGACCCAATATCTACA
GATCCGTCCCCAATAGGTGACGTG -> ATCCGTCCCCAATAGGTGACGTGA
CCTACAAGAGTTAGTTTAACGTAT -> CTACAAGAGTTAGTTTAACGTATC
TCGGCCTTACTGTTCAGATCGAGA -> CGGCCTTACTGTTCAGATCGAGAC
GGTATTAGGAGTGTCAAACAGCAG -> GTATTAGGAGTGTCAAACAGCAGA
AGGGCGGCTCAACCGTTTGTCTTT -> GGGCGGCTCAACCGTTTGTCTTTG
TAGACCAATTAAGTCCGACGGCTC -> AGACCAATTAAGTCCGACGGCTCG
ATCCCCCGTAAATTTGTTACACCC -> TCCCCCGTAAATTTGTTACACCCT
GGGGGTGCATAGCAACTTTGGCGA -> GGGGTGCATAGCAACTTTGGCGAC
CGATTTTTTACGGCCCTCATTATC -> GATTTTTTACGGCCCTCATTATCG
ATCTACAGGGGGCGGGGCCCGACA -> TCTACAGGGGGCGGGGCCCGACAC
TTCCATCGTATATCGTAGGGAATA -> TCCATCGTATATCGTAGGGAATAG
TAGCAACTTTGGCGACTAAATCGG -> AGCAACTTTGGCGACTAAATCGGC
ACTACATGCCGGTTCGAGACCCTC -> CTACATGCCGGTTCGAGACCCTCC
GTTGTCTCTAAGCATCCCTCCATT -> TTGTCTCTAAGCATCCCTCCATTA
CTCGAGCGCTGTCGTAGCAGCAGA -> TCGAGCGCTGTCGTAGCAGCAGAA
AACAGTTTGGTATTAGGAGTGTCA -> ACAGTTTGGTATTAGGAGTGTCAA
TGCCTTCGTTAACTTATGGCTTTC -> GCCTTCGTTAACTTATGGCTTTCC
TAGTGACAAGTGTTCATCTCACCA -> AGTGACAAGTGTTCATCTCACCAA
CTACCGCACAATGGCAGTAGAATT -> TACCGCACAATGGCAGTAGAATTG
AGGTTGCCTCTGTGTAACGGGACC -> GGTTGCCTCTGTGTAACGGGACCA
CTCTAAGCATCCCTCCATTACGTC -> TCTAAGCATCCCTCCATTACGTCC
GCGAGGTCAAAGGGGTAAAACACC -> CGAGGTCAAAGGGGTAAAACACCC
TTGTGCCAGTTCAAACGATAATCT -> TGTGCCAGTTCAAACGATAATCTA
GGATCGAGCGACTCAGATGTAAGT -> GATCGAGCGACTCAGATGTAAGTC
GGAAGATGCTACCAAGGAGCCACT -> GAAGATGCTACCAAGGAGCCACTT
GACCAGATCTCTATAGTGAAGACC -> ACCAGATCTCTATAGTGAAGACCG
ACATTACCTTTGAGCAGCTCGGTG -> CATTACCTTTGAGCAGCTCGGTGA
GCCAAGACAACACGTCGAATATCC -> CCAAGACAACACGTCGAATATCCG
GCAAGTCATGGAACGTCCTTCACT -> CAAGTCATGGAACGTCCTTCACTC
GACTAAATCGGCACTAGTGACAAG -> ACTAAATCGGCACTAGTGACAAGT
CCTAACCAGGATCTCTCTAAAATC -> CTAACCAGGATCTCTCTAAAATCC
CCAATAGGTGACGTGAAACCACGT -> CAATAGGTGACGTGAAACCACGTC
GATCGATCACGCCAAGACAACACG -> ATCGATCACGCCAAGACAACACGT
GTTGTGCCAGTTCAAACGATAATC -> TTGTGCCAGTTCAAACGATAATCT
AACAGGCAGGTCAAACGGTACTAT -> ACAGGCAGGTCAAACGGTACTATG
ATAATCTACGTCCCTCGCGCCACG -> TAATCTACGTCCCTCGCGCCACGA
AGAGGCAACAGTTTGGTATTAGGA -> GAGGCAACAGTTTGGTATTAGGAG
CTGTACACCGGATCGAGCGACTCA -> TGTACACCGGATCGAGCGACTCAG
GCCGGTTCGAGACCCTCCCTGCCT -> CCGGTTCGAGACCCTCCCTGCCTG
GCTTTGTTGAGCACGGAGACGGCG -> CTTTGTTGAGCACGGAGACGGCGG
ACCGCGGACCTCTACCGCACAATG -> CCGCGGACCTCTACCGCACAATGG
ATATGCCTTCGTTAACTTATGGCT -> TATGCCTTCGTTAACTTATGGCTT
GGCTCGACCCGGTAGTCCGATGGA -> GCTCGACCCGGTAGTCCGATGGAC
CACACACCGAAAACATGGTAAAAA -> ACACACCGAAAACATGGTAAAAAT
AAATCGGCACTAGTGACAAGTGTT -> AATCGGCACTAGTGACAAGTGTTC
CGCTGTCGTAGCAGCAGAATGGGT -> GCTGTCGTAGCAGCAGAATGGGTG
CGCAGATTAAATATTGCTAAACCC -> GCAGATTAAATATTGCTAAACCCA
CGATCCGTCCCCAATAGGTGACGT -> GATCCGTCCCCAATAGGTGACGTG
CCCTCCCTGCCTGCCTCGAGTTGT -> CCTCCCTGCCTGCCTCGAGTTGTC
GGGAATAGTGTCAAGTCACCGTCT -> GGAATAGTGTCAAGTCACCGTCTA
TGATATTATTACTACATGCCGGTT -> GATATTATTACTACATGCCGGTTC
CCCTCGCGCCACGAGCTACAACAC -> CCTCGCGCCACGAGCTACAACACA
CCGAAAACATGGTAAAAATGCCAA -> CGAAAACATGGTAAAAATGCCAAA
CGGCTCGACCCGGTAGTCCGATGG -> GGCTCGACCCGGTAGTCCGATGGA
TGTGTCAAATCAGCATGATCGCAG -> GTGTCAAATCAGCATGATCGCAGG
TGCATAGCAACTTTGGCGACTAAA -> GCATAGCAACTTTGGCGACTAAAT
AATTGCTCGCTCATCCAAGGTGTC -> ATTGCTCGCTCATCCAAGGTGTCA
CTTCGGACATCGAATCTGTTATGT -> TTCGGACATCGAATCTGTTATGTC
GTTACCCAAAATACATAGCAGGAC -> TTACCCAAAATACATAGCAGGACC
CTCGAGTTGTCTCTAAGCATCCCT -> TCGAGTTGTCTCTAAGCATCCCTC
TTCGGACATCGAATCTGTTATGTC -> TCGGACATCGAATCTGTTATGTCT
ACTGCCCCAGATCCCGCCACTAGC -> CTGCCCCAGATCCCGCCACTAGCC
ACTGACCCTCTCAGTGTTATGCTC -> CTGACCCTCTCAGTGTTATGCTCT
GCCGCCCGGCACGCGGTAGTACCT -> CCGCCCGGCACGCGGTAGTACCTA
CCCTCCATTACGTCCCACGACTTC -> CCTCCATTACGTCCCACGACTTCT
GCACAATGGCAGTAGAATTGTGAT -> CACAATGGCAGTAGAATTGTGATC
GATCCAGGTATTTGTGTCAAATCA -> ATCCAGGTATTTGTGTCAAATCAG
GCTTAACACAGGAAGTTACCCAAA -> CTTAACACAGGAAGTTACCCAAAA
CTACAAGAGTTAGTTTAACGTATC -> TACAAGAGTTAGTTTAACGTATCG
GCTGATTTATAAGCCAGACCGAAC -> CTGATTTATAAGCCAGACCGAACA
CGAATATCCGTTACATGGATTTGT -> GAATATCCGTTACATGGATTTGTC
ACGTTCGTGCCGCTGAGCAACGGA -> CGTTCGTGCCGCTGAGCAACGGAC
TCTAGACCAATTAAGTCCGACGGC -> CTAGACCAATTAAGTCCGACGGCT
AGCCTCTGTCGGCCTTACTGTTCA -> GCCTCTGTCGGCCTTACTGTTCAG
ATGGTAAAAATGCCAAACATGCGC -> TGGTAAAAATGCCAAACATGCGCG
TAGAGGCAACAGTTTGGTATTAGG -> AGAGGCAACAGTTTGGTATTAGGA
CTCCATTACGTCCCACGACTTCTC -> TCCATTACGTCCCACGACTTCTCA
GTACGTCCGCTAATCTCGACCAAC -> TACGTCCGCTAATCTCGACCAACC
GTCAAACGGTACTATGGTCTCGAT -> TCAAACGGTACTATGGTCTCGATT
GTTGCCTCTGTGTAACGGGACCAG -> TTGCCTCTGTGTAACGGGACCAGC
TTATGTCTGGCCTAACCAGGATCT -> TATGTCTGGCCTAACCAGGATCTC
TTATTCTTTCTCACACGCAGCCCT -> TATTCTTTCTCACACGCAGCCCTG
TCCAAGGTGTCAATGTTCCATCGT -> CCAAGGTGTCAATGTTCCATCGTA
TTGCACAGTTCCGCTGGAACATGC -> TGCACAGTTCCGCTGGAACATGCC
CCGGTAGTCCGATGGACCAGATCT -> CGGTAGTCCGATGGACCAGATCTC
TCCGTTACATGGATTTGTCATGTG -> CCGTTACATGGATTTGTCATGTGA
GGGTGCAGCAGTACTACACTCTCG -> GGTGCAGCAGTACTACACTCTCGT
TACCTATCCCCCGTAAATTTGTTA -> ACCTATCCCCCGTAAATTTGTTAC
CCCCCGTAAATTTGTTACACCCTT -> CCCCGTAAATTTGTTACACCCTTC
GTGGCCGATTTTTTACGGCCCTCA -> TGGCCGATTTTTTACGGCCCTCAT
TAACGCTGTACACCGGATCGAGCG -> AACGCTGTACACCGGATCGAGCGA
AAACCACGTCCTATAGAGCCTGAT -> AACCACGTCCTATAGAGCCTGATT
TAATTCCGCAGATTAAATATTGCT -> AATTCCGCAGATTAAATATTGCTA
ACCGAACATTACCTTTGAGCAGCT -> CCGAACATTACCTTTGAGCAGCTC
CTCATGGAAGATGCTACCAAGGAG -> TCATGGAAGATGCTACCAAGGAGC
TGAAACCACGTCCTATAGAGCCTG -> GAAACCACGTCCTATAGAGCCTGA
ATCAGCATGATCGCAGGTGGGTGC -> TCAGCATGATCGCAGGTGGGTGCA
GCCCCAGATCCCGCCACTAGCCGC -> CCCCAGATCCCGCCACTAGCCGCT
TGAGGCTGATTTATAAGCCAGACC -> GAGGCTGATTTATAAGCCAGACCG
GATTTTTTACGGCCCTCATTATCG -> ATTTTTTACGGCCCTCATTATCGG
GGAGAGGTATTTCTTATTCTTTCT -> GAGAGGTATTTCTTATTCTTTCTC
AGACAACACGTCGAATATCCGTTA -> GACAACACGTCGAATATCCGTTAC
CGGCCTGCACCAGTTTAAGGATCC -> GGCCTGCACCAGTTTAAGGATCCG
TCTACGTCCCTCGCGCCACGAGCT -> CTACGTCCCTCGCGCCACGAGCTA
AGGTCAAACGGTACTATGGTCTCG -> GGTCAAACGGTACTATGGTCTCGA
CAGTTTGGTATTAGGAGTGTCAAA -> AGTTTGGTATTAGGAGTGTCAAAC
AGATTTACGAGAGCTTAGTACGTC -> GATTTACGAGAGCTTAGTACGTCC
GGCAAATTGCTCGCTCATCCAAGG -> GCAAATTGCTCGCTCATCCAAGGT
GATAACACGAATTGCGCTTAACCG -> ATAACACGAATTGCGCTTAACCGT
TATCTACAGGGGGCGGGGCCCGAC -> ATCTACAGGGGGCGGGGCCCGACA
CGTAGAGAGCCCTGTGGCCCCCAA -> GTAGAGAGCCCTGTGGCCCCCAAA
ATCCGTCCCCAATAGGTGACGTGA -> TCCGTCCCCAATAGGTGACGTGAA
CGGGGCCCGACACGGCTGCAAGAA -> GGGGCCCGACACGGCTGCAAGAAC
GCTCGACCCGGTAGTCCGATGGAC -> CTCGACCCGGTAGTCCGATGGACC
TCCGGCTGGTCAGATCCAGGTATT -> CCGGCTGGTCAGATCCAGGTATTT
GGACACAGATCGATGCACGTTTCG -> GACACAGATCGATGCACGTTTCGA
AATGGCAGTAGAATTGTGATCGAT -> ATGGCAGTAGAATTGTGATCGATC
GCCGATTTTTTACGGCCCTCATTA -> CCGATTTTTTACGGCCCTCATTAT
CAGCATGATCGCAGGTGGGTGCAG -> AGCATGATCGCAGGTGGGTGCAGC
GAGTTAGTGGCCGATTTTTTACGG -> AGTTAGTGGCCGATTTTTTACGGC
CAGTGTTATGCTCTGAGTTAGCCG -> AGTGTTATGCTCTGAGTTAGCCGA
AATACATAGCAGGACCCAATATCT -> ATACATAGCAGGACCCAATATCTA
ATATGCTTACAACTCGCACTTCGG -> TATGCTTACAACTCGCACTTCGGA
CAGGGGGCGGGGCCCGACACGGCT -> AGGGGGCGGGGCCCGACACGGCTG
GGTAAAACACCCTGATATTATTAC -> GTAAAACACCCTGATATTATTACT
TTCAGACTGCCCCAGATCCCGCCA -> TCAGACTGCCCCAGATCCCGCCAC
AGCTACAACACACCGAAGTTTTGG -> GCTACAACACACCGAAGTTTTGGA
CCTGTTGTGCCAGTTCAAACGATA -> CTGTTGTGCCAGTTCAAACGATAA
GAACAGGCAGGTCAAACGGTACTA -> AACAGGCAGGTCAAACGGTACTAT
CAGGTTTTAATAGTGATACTCCGA -> AGGTTTTAATAGTGATACTCCGAA
ACAACACACCGAAGTTTTGGAGGT -> CAACACACCGAAGTTTTGGAGGTA
AGATGCTACCAAGGAGCCACTTCG -> GATGCTACCAAGGAGCCACTTCGA
GCTGTCAACCTACCGTTGATTCAC -> CTGTCAACCTACCGTTGATTCACA
AGCAAGTCATGGAACGTCCTTCAC -> GCAAGTCATGGAACGTCCTTCACT
TGAGCAACGGACCACCCTACAAGA -> GAGCAACGGACCACCCTACAAGAG
TCTCTAAGCATCCCTCCATTACGT -> CTCTAAGCATCCCTCCATTACGTC
TGGCGATGCACGGGTGACCGTTCT -> GGCGATGCACGGGTGACCGTTCTG
GCCCGCTCTCTCGCGTGGCAAATT -> CCCGCTCTCTCGCGTGGCAAATTG
CAGCAGTACTACACTCTCGTTGAA -> AGCAGTACTACACTCTCGTTGAAT
CCCGGTAGTCCGATGGACCAGATC -> CCGGTAGTCCGATGGACCAGATCT
GAATATCCGTTACATGGATTTGTC -> AATATCCGTTACATGGATTTGTCA
CTGTCGTAGCAGCAGAATGGGTGT -> TGTCGTAGCAGCAGAATGGGTGTC
TTAGTGGCCGATTTTTTACGGCCC -> TAGTGGCCGATTTTTTACGGCCCT
GGACCTCTACCGCACAATGGCAGT -> GACCTCTACCGCACAATGGCAGTA
TCTAATGTTACCTCGACCATGGAC -> CTAATGTTACCTCGACCATGGACA
CAGAATGGGTGTCGAAGCCTCTGT -> AGAATGGGTGTCGAAGCCTCTGTC
AACGGGACCAGCCCGCTCTCTCGC -> ACGGGACCAGCCCGCTCTCTCGCG
GCACGGGTGACCGTTCTGGAATCG -> CACGGGTGACCGTTCTGGAATCGT
TGCCTCGAGTTGTCTCTAAGCATC -> GCCTCGAGTTGTCTCTAAGCATCC
GCTGAGCAACGGACCACCCTACAA -> CTGAGCAACGGACCACCCTACAAG
TCGACCCGGTAGTCCGATGGACCA -> CGACCCGGTAGTCCGATGGACCAG
ACGGACCACCCTACAAGAGTTAGT -> CGGACCACCCTACAAGAGTTAGTT
GCTTAGTACGTCCGCTAATCTCGA -> CTTAGTACGTCCGCTAATCTCGAC
CCGTCTTTGAATGAGGCTGATTTA -> CGTCTTTGAATGAGGCTGATTTAT
TTTGGAGGTAAGATAACACGAATT -> TTGGAGGTAAGATAACACGAATTG
AGTTACCCAAAATACATAGCAGGA -> GTTACCCAAAATACATAGCAGGAC
CGGTAGTCCGATGGACCAGATCTC -> GGTAGTCCGATGGACCAGATCTCT
TGGTAAGTGTAGCCTGTAACGCTG -> GGTAAGTGTAGCCTGTAACGCTGT
ACCTACCGTTGATTCACACATCAA -> CCTACCGTTGATTCACACATCAAA
GCACTAGTGACAAGTGTTCATCTC -> CACTAGTGACAAGTGTTCATCTCA
AACATGCGCGAGGTCAAAGGGGTA -> ACATGCGCGAGGTCAAAGGGGTAA
CTGCAGGTTTTAATAGTGATACTC -> TGCAGGTTTTAATAGTGATACTCC
AATATCTACAGGGGGCGGGGCCCG -> ATATCTACAGGGGGCGGGGCCCGA
GTTCCGCTGGAACATGCCAACTGA -> TTCCGCTGGAACATGCCAACTGAG
GGGCGGCTCAACCGTTTGTCTTTG -> GGCGGCTCAACCGTTTGTCTTTGG
GTGTCGAAGCCTCTGTCGGCCTTA -> TGTCGAAGCCTCTGTCGGCCTTAC
CAACAGTTTGGTATTAGGAGTGTC -> AACAGTTTGGTATTAGGAGTGTCA
CCAGTTTAAGGATCCGATCCGTCC -> CAGTTTAAGGATCCGATCCGTCCC
AGGTGTCAATGTTCCATCGTATAT -> GGTGTCAATGTTCCATCGTATATC
GCAGCAGAATGGGTGTCGAAGCCT -> CAGCAGAATGGGTGTCGAAGCCTC
TGCACCAGTTTAAGGATCCGATCC -> GCACCAGTTTAAGGATCCGATCCG
TGTTGTGCCAGTTCAAACGATAAT -> GTTGTGCCAGTTCAAACGATAATC
GCAGATTAAATATTGCTAAACCCA -> CAGATTAAATATTGCTAAACCCAA
GTGAAACCACGTCCTATAGAGCCT -> TGAAACCACGTCCTATAGAGCCTG
CTCAGGTAGGTACCGCGGACCTCT -> TCAGGTAGGTACCGCGGACCTCTA
GGGGGCGGGGCCCGACACGGCTGC -> GGGGCGGGGCCCGACACGGCTGCA
AGAATTGTGATCGATCACGCCAAG -> GAATTGTGATCGATCACGCCAAGA
CAGGAAGTTACCCAAAATACATAG -> AGGAAGTTACCCAAAATACATAGC
AGCAAGGGCACGGATAATCGTAGA -> GCAAGGGCACGGATAATCGTAGAG
CTGCACCAGTTTAAGGATCCGATC -> TGCACCAGTTTAAGGATCCGATCC
CGCTTAACCGTTTCTGCAACTGAC -> GCTTAACCGTTTCTGCAACTGACC
TGCTCTGAGTTAGCCGATATGCTT -> GCTCTGAGTTAGCCGATATGCTTA
TAAAAATGCCAAACATGCGCGAGG -> AAAAATGCCAAACATGCGCGAGGT
TGAATAATTCCGCAGATTAAATAT -> GAATAATTCCGCAGATTAAATATT
GAGGTAAGATAACACGAATTGCGC -> AGGTAAGATAACACGAATTGCGCT
CCAATATCTACAGGGGGCGGGGCC -> CAATATCTACAGGGGGCGGGGCCC
AATATCCGTTACATGGATTTGTCA -> ATATCCGTTACATGGATTTGTCAT
CACCGTCTAATGTTACCTCGACCA -> ACCGTCTAATGTTACCTCGACCAT
GCGGTTTGTTCTCAAAGGGCGGCT -> CGGTTTGTTCTCAAAGGGCGGCTC
AAGTCATGGAACGTCCTTCACTCC -> AGTCATGGAACGTCCTTCACTCCG
CAAGGAGCCACTTCGAATAATGGC -> AAGGAGCCACTTCGAATAATGGCG
TCGAAACTATATGCCTTCGTTAAC -> CGAAACTATATGCCTTCGTTAACT
ACGCTCAGGTAGGTACCGCGGACC -> CGCTCAGGTAGGTACCGCGGACCT
CCAACTGAGTTAGTGGCCGATTTT -> CAACTGAGTTAGTGGCCGATTTTT
TGTAACGCTGTACACCGGATCGAG -> GTAACGCTGTACACCGGATCGAGC
AGAGAGCCCTGTGGCCCCCAAAGC -> GAGAGCCCTGTGGCCCCCAAAGCA
AAGGATCCGATCCGTCCCCAATAG -> AGGATCCGATCCGTCCCCAATAGG
AAATCAGCATGATCGCAGGTGGGT -> AATCAGCATGATCGCAGGTGGGTG
TCAAACGATAATCTACGTCCCTCG -> CAAACGATAATCTACGTCCCTCGC
TTGGTATTAGGAGTGTCAAACAGC -> TGGTATTAGGAGTGTCAAACAGCA
CGATGGACCAGATCTCTATAGTGA -> GATGGACCAGATCTCTATAGTGAA
CCGCGGACCTCTACCGCACAATGG -> CGCGGACCTCTACCGCACAATGGC
TTCACACATCAAACGTTCGTGCCG -> TCACACATCAAACGTTCGTGCCGC
GATTGTACAAAGGTTGCCTCTGTG -> ATTGTACAAAGGTTGCCTCTGTGT
TTACAACTCGCACTTCGGACATCG -> TACAACTCGCACTTCGGACATCGA
TGCACAGTTCCGCTGGAACATGCC -> GCACAGTTCCGCTGGAACATGCCA
AGGTCACGCTCAGGTAGGTACCGC -> GGTCACGCTCAGGTAGGTACCGCG
CAGATCTCTATAGTGAAGACCGGA -> AGATCTCTATAGTGAAGACCGGAC
TCTGAGTTAGCCGATATGCTTACA -> CTGAGTTAGCCGATATGCTTACAA
GTGTTCATCTCACCAATACTACAG -> TGTTCATCTCACCAATACTACAGG
CAAACAGCAGATTTACGAGAGCTT -> AAACAGCAGATTTACGAGAGCTTA
CTCGACCAACCTTATTATCCCGTC -> TCGACCAACCTTATTATCCCGTCT
TCCATCGTATATCGTAGGGAATAG -> CCATCGTATATCGTAGGGAATAGT
CGTATCGCTTTGTTGAGCACGGAG -> GTATCGCTTTGTTGAGCACGGAGA
GGGGTGCATAGCAACTTTGGCGAC -> GGGTGCATAGCAACTTTGGCGACT
CTGTGGCCCCCAAAGCAAGTCATG -> TGTGGCCCCCAAAGCAAGTCATGG
CCCCGTAAATTTGTTACACCCTTC -> CCCGTAAATTTGTTACACCCTTCC
GTAGAATTGTGATCGATCACGCCA -> TAGAATTGTGATCGATCACGCCAA
CCGGATCGAGCGACTCAGATGTAA -> CGGATCGAGCGACTCAGATGTAAG
GGAGGTCACGCTCAGGTAGGTACC -> GAGGTCACGCTCAGGTAGGTACCG
GGATCCGATCCGTCCCCAATAGGT -> GATCCGATCCGTCCCCAATAGGTG
CTATTCAGACTGCCCCAGATCCCG -> TATTCAGACTGCCCCAGATCCCGC
CGGCTGGTCAGATCCAGGTATTTG -> GGCTGGTCAGATCCAGGTATTTGT
AGTCACCGTCTAATGTTACCTCGA -> GTCACCGTCTAATGTTACCTCGAC
GAACATTACCTTTGAGCAGCTCGG -> AACATTACCTTTGAGCAGCTCGGT
CCTCCCTGCCTGCCTCGAGTTGTC -> CTCCCTGCCTGCCTCGAGTTGTCT
ACTTATGGCTTTCCACGCTTAACA -> CTTATGGCTTTCCACGCTTAACAC
CTCCCTGCCTGCCTCGAGTTGTCT -> TCCCTGCCTGCCTCGAGTTGTCTC
CAAAGGTTGCCTCTGTGTAACGGG -> AAAGGTTGCCTCTGTGTAACGGGA
CTAATGTTACCTCGACCATGGACA -> TAATGTTACCTCGACCATGGACAC
CGAAGCCTCTGTCGGCCTTACTGT -> GAAGCCTCTGTCGGCCTTACTGTT
TAGCAGGACCCAATATCTACAGGG -> AGCAGGACCCAATATCTACAGGGG
TATCGTAGGGAATAGTGTCAAGTC -> ATCGTAGGGAATAGTGTCAAGTCA
ACGCCTGTTGTGCCAGTTCAAACG -> CGCCTGTTGTGCCAGTTCAAACGA
GGTAAGTGTAGCCTGTAACGCTGT -> GTAAGTGTAGCCTGTAACGCTGTA
ACAGGGGGCGGGGCCCGACACGGC -> CAGGGGGCGGGGCCCGACACGGCT
ACACATCAAACGTTCGTGCCGCTG -> CACATCAAACGTTCGTGCCGCTGA
TACCGCGGACCTCTACCGCACAAT -> ACCGCGGACCTCTACCGCACAATG
GGCGGGGCCCGACACGGCTGCAAG -> GCGGGGCCCGACACGGCTGCAAGA
TAGAATTGTGATCGATCACGCCAA -> AGAATTGTGATCGATCACGCCAAG
AACTATATGCCTTCGTTAACTTAT -> ACTATATGCCTTCGTTAACTTATG
AGTGATACTCCGAACGTAATGGAG -> GTGATACTCCGAACGTAATGGAGA
TACAACACACCGAAGTTTTGGAGG -> ACAACACACCGAAGTTTTGGAGGT
CCGTTGATTCACACATCAAACGTT -> CGTTGATTCACACATCAAACGTTC
TTTAATAGTGATACTCCGAACGTA -> TTAATAGTGATACTCCGAACGTAA
CCGTTTGTCTTTGGTAAGTGTAGC -> CGTTTGTCTTTGGTAAGTGTAGCC
CCGATCCGTCCCCAATAGGTGACG -> CGATCCGTCCCCAATAGGTGACGT
ACCTTTGAGCAGCTCGGTGAGTGT -> CCTTTGAGCAGCTCGGTGAGTGTC
CTGGCCTAACCAGGATCTCTCTAA -> TGGCCTAACCAGGATCTCTCTAAA
CTGACTCGAGCGCTGTCGTAGCAG -> TGACTCGAGCGCTGTCGTAGCAGC
CTCTCAGTGTTATGCTCTGAGTTA -> TCTCAGTGTTATGCTCTGAGTTAG
CTGAGTTAGTGGCCGATTTTTTAC -> TGAGTTAGTGGCCGATTTTTTACG
TACCCAAAATACATAGCAGGACCC -> ACCCAAAATACATAGCAGGACCCA
CGTATATCGTAGGGAATAGTGTCA -> GTATATCGTAGGGAATAGTGTCAA
GATACTCCGAACGTAATGGAGAGG -> ATACTCCGAACGTAATGGAGAGGT
ACGTTTCGAAACTATATGCCTTCG -> CGTTTCGAAACTATATGCCTTCGT
ACGAATTGCGCTTAACCGTTTCTG -> CGAATTGCGCTTAACCGTTTCTGC
CCAAGGAGCCACTTCGAATAATGG -> CAAGGAGCCACTTCGAATAATGGC
CACGCCAAGACAACACGTCGAATA -> ACGCCAAGACAACACGTCGAATAT
ATTGCTAAACCCAAGACGGGACGA -> TTGCTAAACCCAAGACGGGACGAT
CCCCCAAAGCAAGTCATGGAACGT -> CCCCAAAGCAAGTCATGGAACGTC
TCGATGCACGTTTCGAAACTATAT -> CGATGCACGTTTCGAAACTATATG
CCAAAGCAAGTCATGGAACGTCCT -> CAAAGCAAGTCATGGAACGTCCTT
GGCGATGCACGGGTGACCGTTCTG -> GCGATGCACGGGTGACCGTTCTGG
GACTTCTCATGGAAGATGCTACCA -> ACTTCTCATGGAAGATGCTACCAA
TAGGGAATAGTGTCAAGTCACCGT -> AGGGAATAGTGTCAAGTCACCGTC
CATAGCAACTTTGGCGACTAAATC -> ATAGCAACTTTGGCGACTAAATCG
ACCGGATCGAGCGACTCAGATGTA -> CCGGATCGAGCGACTCAGATGTAA
ATGGAAGATGCTACCAAGGAGCCA -> TGGAAGATGCTACCAAGGAGCCAC
GTAATGGAGAGGTATTTCTTATTC -> TAATGGAGAGGTATTTCTTATTCT
ATGTTGCCATCAATTCTGCAGGTT -> TGTTGCCATCAATTCTGCAGGTTT
CGGACCTCTACCGCACAATGGCAG -> GGACCTCTACCGCACAATGGCAGT
GTGCCGCTGAGCAACGGACCACCC -> TGCCGCTGAGCAACGGACCACCCT
AGCGACTCAGATGTAAGTCTATAG -> GCGACTCAGATGTAAGTCTATAGC
CTGCCTCGAGTTGTCTCTAAGCAT -> TGCCTCGAGTTGTCTCTAAGCATC
TGAGGGAACAGGCAGGTCAAACGG -> GAGGGAACAGGCAGGTCAAACGGT
TAACTTATGGCTTTCCACGCTTAA -> AACTTATGGCTTTCCACGCTTAAC
GAGCCCTGTGGCCCCCAAAGCAAG -> AGCCCTGTGGCCCCCAAAGCAAGT
GCTACCAAGGAGCCACTTCGAATA -> CTACCAAGGAGCCACTTCGAATAA
TCGACCAACCTTATTATCCCGTCT -> CGACCAACCTTATTATCCCGTCTT
GCCCGGCACGCGGTAGTACCTATC -> CCCGGCACGCGGTAGTACCTATCC
ACTAGCCGCTGTCAACCTACCGTT -> CTAGCCGCTGTCAACCTACCGTTG
ACTAGTGACAAGTGTTCATCTCAC -> CTAGTGACAAGTGTTCATCTCACC
CACAATGGCAGTAGAATTGTGATC -> ACAATGGCAGTAGAATTGTGATCG
TGATTTATAAGCCAGACCGAACAT -> GATTTATAAGCCAGACCGAACATT
ATCGGCACTAGTGACAAGTGTTCA -> TCGGCACTAGTGACAAGTGTTCAT
CATAGCAGGACCCAATATCTACAG -> ATAGCAGGACCCAATATCTACAGG
AAACCCAAGACGGGACGATGTTGC -> AACCCAAGACGGGACGATGTTGCC
ACCAGGATCTCTCTAAAATCCTTG -> CCAGGATCTCTCTAAAATCCTTGC
AGCAGTACTACACTCTCGTTGAAT -> GCAGTACTACACTCTCGTTGAATA
GCCTGCCTCGAGTTGTCTCTAAGC -> CCTGCCTCGAGTTGTCTCTAAGCA
AAGTGTAGCCTGTAACGCTGTACA -> AGTGTAGCCTGTAACGCTGTACAC
TTCCGCTGGAACATGCCAACTGAG -> TCCGCTGGAACATGCCAACTGAGT
CATGCCGGTTCGAGACCCTCCCTG -> ATGCCGGTTCGAGACCCTCCCTGC
AACGATAATCTACGTCCCTCGCGC -> ACGATAATCTACGTCCCTCGCGCC
AAAACATGGTAAAAATGCCAAACA -> AAACATGGTAAAAATGCCAAACAT
ATCTGTTATGTCTGGCCTAACCAG -> TCTGTTATGTCTGGCCTAACCAGG
AACGTATCGCTTTGTTGAGCACGG -> ACGTATCGCTTTGTTGAGCACGGA
TAATGGAGAGGTATTTCTTATTCT -> AATGGAGAGGTATTTCTTATTCTT
CGCTCAGGTAGGTACCGCGGACCT -> GCTCAGGTAGGTACCGCGGACCTC
AATTAAGTCCGACGGCTCGACCCG -> ATTAAGTCCGACGGCTCGACCCGG
GGTGAGTGTCGCGGTTTGTTCTCA -> GTGAGTGTCGCGGTTTGTTCTCAA
ACTATATGCCTTCGTTAACTTATG -> CTATATGCCTTCGTTAACTTATGG
AATATTGCTAAACCCAAGACGGGA -> ATATTGCTAAACCCAAGACGGGAC
GTCCCCAATAGGTGACGTGAAACC -> TCCCCAATAGGTGACGTGAAACCA
GTAGCAGCAGAATGGGTGTCGAAG -> TAGCAGCAGAATGGGTGTCGAAGC
CCTTCACTCCGCAACGGCACACAC -> CTTCACTCCGCAACGGCACACACC
TTACGAGAGCTTAGTACGTCCGCT -> TACGAGAGCTTAGTACGTCCGCTA
AGTCCGACGGCTCGACCCGGTAGT -> GTCCGACGGCTCGACCCGGTAGTC
GACAACACGTCGAATATCCGTTAC -> ACAACACGTCGAATATCCGTTACA
AGAACGCCTGTTGTGCCAGTTCAA -> GAACGCCTGTTGTGCCAGTTCAAA
TCGCGTGGCAAATTGCTCGCTCAT -> CGCGTGGCAAATTGCTCGCTCATC
ACGGCGGCAATATCTCAGGCTAGA -> CGGCGGCAATATCTCAGGCTAGAG
CAAGGTGTCAATGTTCCATCGTAT -> AAGGTGTCAATGTTCCATCGTATA
AGGTAGGTACCGCGGACCTCTACC -> GGTAGGTACCGCGGACCTCTACCG
CTCGCGTGGCAAATTGCTCGCTCA -> TCGCGTGGCAAATTGCTCGCTCAT
ACAGTTCCGCTGGAACATGCCAAC -> CAGTTCCGCTGGAACATGCCAACT
CATTACCTTTGAGCAGCTCGGTGA -> ATTACCTTTGAGCAGCTCGGTGAG
CAGATCCCGCCACTAGCCGCTGTC -> AGATCCCGCCACTAGCCGCTGTCA
ATTTACGAGAGCTTAGTACGTCCG -> TTTACGAGAGCTTAGTACGTCCGC
CAGTTTAAGGATCCGATCCGTCCC -> AGTTTAAGGATCCGATCCGTCCCC
GAATTGCGCTTAACCGTTTCTGCA -> AATTGCGCTTAACCGTTTCTGCAA
ATTTTTTACGGCCCTCATTATCGG -> TTTTTTACGGCCCTCATTATCGGC
ATAATCGTAGAGAGCCCTGTGGCC -> TAATCGTAGAGAGCCCTGTGGCCC
ATATCTCAGGCTAGAGGCAACAGT -> TATCTCAGGCTAGAGGCAACAGTT
ATCTCAGGCTAGAGGCAACAGTTT -> TCTCAGGCTAGAGGCAACAGTTTG
AGACCAATTAAGTCCGACGGCTCG -> GACCAATTAAGTCCGACGGCTCGA
TTAGTTTAACGTATCGCTTTGTTG -> TAGTTTAACGTATCGCTTTGTTGA
GACCTCTACCGCACAATGGCAGTA -> ACCTCTACCGCACAATGGCAGTAG
AACTCGCACTTCGGACATCGAATC -> ACTCGCACTTCGGACATCGAATCT
ACCGTCTAATGTTACCTCGACCAT -> CCGTCTAATGTTACCTCGACCATG
GCCATCAATTCTGCAGGTTTTAAT -> CCATCAATTCTGCAGGTTTTAATA
GAGCTACAACACACCGAAGTTTTG -> AGCTACAACACACCGAAGTTTTGG
TCACACGCAGCCCTGACTCGAGCG -> CACACGCAGCCCTGACTCGAGCGC
TCTATAGTGAAGACCGGACACTGC -> CTATAGTGAAGACCGGACACTGCC
ACTCTCGTTGAATAATTCCGCAGA -> CTCTCGTTGAATAATTCCGCAGAT
CCGTTACATGGATTTGTCATGTGA -> CGTTACATGGATTTGTCATGTGAG
CAGGCAGGTCAAACGGTACTATGG -> AGGCAGGTCAAACGGTACTATGGT
GTGTCAAACAGCAGATTTACGAGA -> TGTCAAACAGCAGATTTACGAGAG
CAAATTGCTCGCTCATCCAAGGTG -> AAATTGCTCGCTCATCCAAGGTGT
GATTTATAAGCCAGACCGAACATT -> ATTTATAAGCCAGACCGAACATTA
TGTGTAACGGGACCAGCCCGCTCT -> GTGTAACGGGACCAGCCCGCTCTC
GTTCTCAAAGGGCGGCTCAACCGT -> TTCTCAAAGGGCGGCTCAACCGTT
CACGAGCTACAACACACCGAAGTT -> ACGAGCTACAACACACCGAAGTTT
TATTTCTTATTCTTTCTCACACGC -> ATTTCTTATTCTTTCTCACACGCA
GTCAATGTTCCATCGTATATCGTA -> TCAATGTTCCATCGTATATCGTAG
CACATCAAACGTTCGTGCCGCTGA -> ACATCAAACGTTCGTGCCGCTGAG
ACAACACGTCGAATATCCGTTACA -> CAACACGTCGAATATCCGTTACAT
ACGTCCTATAGAGCCTGATTCTAG -> CGTCCTATAGAGCCTGATTCTAGA
GCGCTGTCGTAGCAGCAGAATGGG -> CGCTGTCGTAGCAGCAGAATGGGT
CTTCGTTAACTTATGGCTTTCCAC -> TTCGTTAACTTATGGCTTTCCACG
TCCGCAGATTAAATATTGCTAAAC -> CCGCAGATTAAATATTGCTAAACC
CTTTCCACGCTTAACACAGGAAGT -> TTTCCACGCTTAACACAGGAAGTT
GATCCGATCCGTCCCCAATAGGTG -> ATCCGATCCGTCCCCAATAGGTGA
GAGCAACGGACCACCCTACAAGAG -> AGCAACGGACCACCCTACAAGAGT
ACGTCGAATATCCGTTACATGGAT -> CGTCGAATATCCGTTACATGGATT
CATCAAACGTTCGTGCCGCTGAGC -> ATCAAACGTTCGTGCCGCTGAGCA
TAACGGGACCAGCCCGCTCTCTCG -> AACGGGACCAGCCCGCTCTCTCGC
CCGCTGGAACATGCCAACTGAGTT -> CGCTGGAACATGCCAACTGAGTTA
CCCTGTGGCCCCCAAAGCAAGTCA -> CCTGTGGCCCCCAAAGCAAGTCAT
GCAGGTCAAACGGTACTATGGTCT -> CAGGTCAAACGGTACTATGGTCTC
TTACCCAAAATACATAGCAGGACC -> TACCCAAAATACATAGCAGGACCC
CAACTCGCACTTCGGACATCGAAT -> AACTCGCACTTCGGACATCGAATC
ACCCAATATCTACAGGGGGCGGGG -> CCCAATATCTACAGGGGGCGGGGC
GACCCGGTAGTCCGATGGACCAGA -> ACCCGGTAGTCCGATGGACCAGAT
AGAGCCTGATTCTAGACCAATTAA -> GAGCCTGATTCTAGACCAATTAAG
ACCTCTACCGCACAATGGCAGTAG -> CCTCTACCGCACAATGGCAGTAGA
ATCGATCACGCCAAGACAACACGT -> TCGATCACGCCAAGACAACACGTC
AACGGACCACCCTACAAGAGTTAG -> ACGGACCACCCTACAAGAGTTAGT
TCAGGCTAGAGGCAACAGTTTGGT -> CAGGCTAGAGGCAACAGTTTGGTA
AGATCGATGCACGTTTCGAAACTA -> GATCGATGCACGTTTCGAAACTAT
TTAACACAGGAAGTTACCCAAAAT -> TAACACAGGAAGTTACCCAAAATA
TGTAGCCTGTAACGCTGTACACCG -> GTAGCCTGTAACGCTGTACACCGG
ATAGCAAGGGCACGGATAATCGTA -> TAGCAAGGGCACGGATAATCGTAG
GCCAGACCGAACATTACCTTTGAG -> CCAGACCGAACATTACCTTTGAGC
AGAATGGGTGTCGAAGCCTCTGTC -> GAATGGGTGTCGAAGCCTCTGTCG
GGGGCGGGGCCCGACACGGCTGCA -> GGGCGGGGCCCGACACGGCTGCAA
TAACACGAATTGCGCTTAACCGTT -> AACACGAATTGCGCTTAACCGTTT
TGCAAGAACGCCTGTTGTGCCAGT -> GCAAGAACGCCTGTTGTGCCAGTT
GAACGTCCTTCACTCCGCAACGGC -> AACGTCCTTCACTCCGCAACGGCA
CGTAGCCTCCCTTAAGTCACGGGG -> GTAGCCTCCCTTAAGTCACGGGGG
GTGAGTGTCGCGGTTTGTTCTCAA -> TGAGTGTCGCGGTTTGTTCTCAAA
CTAGACCAATTAAGTCCGACGGCT -> TAGACCAATTAAGTCCGACGGCTC
ACATCGAATCTGTTATGTCTGGCC -> CATCGAATCTGTTATGTCTGGCCT
CCAGTTCAAACGATAATCTACGTC -> CAGTTCAAACGATAATCTACGTCC
GTCGCGGTTTGTTCTCAAAGGGCG -> TCGCGGTTTGTTCTCAAAGGGCGG
TCCGAACGTAATGGAGAGGTATTT -> CCGAACGTAATGGAGAGGTATTTC
AAGTGTTCATCTCACCAATACTAC -> AGTGTTCATCTCACCAATACTACA
GCCACTAGCCGCTGTCAACCTACC -> CCACTAGCCGCTGTCAACCTACCG
ATGCCAACTGAGTTAGTGGCCGAT -> TGCCAACTGAGTTAGTGGCCGATT
GTTAGTGGCCGATTTTTTACGGCC -> TTAGTGGCCGATTTTTTACGGCCC
GAGGTCACGCTCAGGTAGGTACCG -> AGGTCACGCTCAGGTAGGTACCGC
GACGGCGGCAATATCTCAGGCTAG -> ACGGCGGCAATATCTCAGGCTAGA
CGTGAAACCACGTCCTATAGAGCC -> GTGAAACCACGTCCTATAGAGCCT
CGCTCTCTCGCGTGGCAAATTGCT -> GCTCTCTCGCGTGGCAAATTGCTC
GCCCCCAAAGCAAGTCATGGAACG -> CCCCCAAAGCAAGTCATGGAACGT
CATCGTATATCGTAGGGAATAGTG -> ATCGTATATCGTAGGGAATAGTGT
CACAGATCGATGCACGTTTCGAAA -> ACAGATCGATGCACGTTTCGAAAC
CACCGAAAACATGGTAAAAATGCC -> ACCGAAAACATGGTAAAAATGCCA
CACCAATACTACAGGTCGTGGTCC -> ACCAATACTACAGGTCGTGGTCCC
TTCTGCAGGTTTTAATAGTGATAC -> TCTGCAGGTTTTAATAGTGATACT
ATAGCAACTTTGGCGACTAAATCG -> TAGCAACTTTGGCGACTAAATCGG
TATCCCCCGTAAATTTGTTACACC -> ATCCCCCGTAAATTTGTTACACCC
AAAGGGCGGCTCAACCGTTTGTCT -> AAGGGCGGCTCAACCGTTTGTCTT
AAGGGCGGCTCAACCGTTTGTCTT -> AGGGCGGCTCAACCGTTTGTCTTT
TTTTACGGCCCTCATTATCGGCCT -> TTTACGGCCCTCATTATCGGCCTG
TTACTGTTCAGATCGAGACGTAGC -> TACTGTTCAGATCGAGACGTAGCC
GACTGCCCCAGATCCCGCCACTAG -> ACTGCCCCAGATCCCGCCACTAGC
TGCGCGAGGTCAAAGGGGTAAAAC -> GCGCGAGGTCAAAGGGGTAAAACA
CCACTTCGAATAATGGCGATGCAC -> CACTTCGAATAATGGCGATGCACG
AAATACATAGCAGGACCCAATATC -> AATACATAGCAGGACCCAATATCT
TCAATTCTGCAGGTTTTAATAGTG -> CAATTCTGCAGGTTTTAATAGTGA
TAAAATCCTTGCACAGTTCCGCTG -> AAAATCCTTGCACAGTTCCGCTGG
ATTCACACATCAAACGTTCGTGCC -> TTCACACATCAAACGTTCGTGCCG
TCCGCTGGAACATGCCAACTGAGT -> CCGCTGGAACATGCCAACTGAGTT
GTGCAGCAGTACTACACTCTCGTT -> TGCAGCAGTACTACACTCTCGTTG
TGCCAAACATGCGCGAGGTCAAAG -> GCCAAACATGCGCGAGGTCAAAGG
TTATCGGCCTGCACCAGTTTAAGG -> TATCGGCCTGCACCAGTTTAAGGA
TAATGTTACCTCGACCATGGACAC -> AATGTTACCTCGACCATGGACACA
GATCGCAGGTGGGTGCAGCAGTAC -> ATCGCAGGTGGGTGCAGCAGTACT
GCCTTCGTTAACTTATGGCTTTCC -> CCTTCGTTAACTTATGGCTTTCCA
AACGCTGTACACCGGATCGAGCGA -> ACGCTGTACACCGGATCGAGCGAC
CAACCTTATTATCCCGTCTTTGAA -> AACCTTATTATCCCGTCTTTGAAT
CTGTAACGCTGTACACCGGATCGA -> TGTAACGCTGTACACCGGATCGAG
TACCTCGACCATGGACACAGATCG -> ACCTCGACCATGGACACAGATCGA
TGCTACCAAGGAGCCACTTCGAAT -> GCTACCAAGGAGCCACTTCGAATA
GAGGCAACAGTTTGGTATTAGGAG -> AGGCAACAGTTTGGTATTAGGAGT
TGGCCCCCAAAGCAAGTCATGGAA -> GGCCCCCAAAGCAAGTCATGGAAC
AGATCTCTATAGTGAAGACCGGAC -> GATCTCTATAGTGAAGACCGGACA
TGTGCCAGTTCAAACGATAATCTA -> GTGCCAGTTCAAACGATAATCTAC
GTATTTGTGTCAAATCAGCATGAT -> TATTTGTGTCAAATCAGCATGATC
CGGTACTATGGTCTCGATTGTACA -> GGTACTATGGTCTCGATTGTACAA
CGTCTTTGAATGAGGCTGATTTAT -> GTCTTTGAATGAGGCTGATTTATA
CAACTTTGGCGACTAAATCGGCAC -> AACTTTGGCGACTAAATCGGCACT
CGAAACTATATGCCTTCGTTAACT -> GAAACTATATGCCTTCGTTAACTT
AATTGCGCTTAACCGTTTCTGCAA -> ATTGCGCTTAACCGTTTCTGCAAC
ATTATCGGCCTGCACCAGTTTAAG -> TTATCGGCCTGCACCAGTTTAAGG
GCAAGGGCACGGATAATCGTAGAG -> CAAGGGCACGGATAATCGTAGAGA
TAACGTATCGCTTTGTTGAGCACG -> AACGTATCGCTTTGTTGAGCACGG
GCGGCTCAACCGTTTGTCTTTGGT -> CGGCTCAACCGTTTGTCTTTGGTA
ACCTCGACCATGGACACAGATCGA -> CCTCGACCATGGACACAGATCGAT
GTCGAAGCCTCTGTCGGCCTTACT -> TCGAAGCCTCTGTCGGCCTTACTG
GCAGGTGGGTGCAGCAGTACTACA -> CAGGTGGGTGCAGCAGTACTACAC
GGGTGCATAGCAACTTTGGCGACT -> GGTGCATAGCAACTTTGGCGACTA
ATATCCGTTACATGGATTTGTCAT -> TATCCGTTACATGGATTTGTCATG
CATGCCAACTGAGTTAGTGGCCGA -> ATGCCAACTGAGTTAGTGGCCGAT
CCAAACATGCGCGAGGTCAAAGGG -> CAAACATGCGCGAGGTCAAAGGGG
TGAGTTAGTGGCCGATTTTTTACG -> GAGTTAGTGGCCGATTTTTTACGG
GGCTAGAGGCAACAGTTTGGTATT -> GCTAGAGGCAACAGTTTGGTATTA
CTCAGTGTTATGCTCTGAGTTAGC -> TCAGTGTTATGCTCTGAGTTAGCC
GGTACCGCGGACCTCTACCGCACA -> GTACCGCGGACCTCTACCGCACAA
CCGGCACGCGGTAGTACCTATCCC -> CGGCACGCGGTAGTACCTATCCCC
CGCGGACCTCTACCGCACAATGGC -> GCGGACCTCTACCGCACAATGGCA
CCTTTGAGCAGCTCGGTGAGTGTC -> CTTTGAGCAGCTCGGTGAGTGTCG
GGTCAAAGGGGTAAAACACCCTGA -> GTCAAAGGGGTAAAACACCCTGAT
TGGCAGTAGAATTGTGATCGATCA -> GGCAGTAGAATTGTGATCGATCAC
ACAGATCGATGCACGTTTCGAAAC -> CAGATCGATGCACGTTTCGAAACT
CGCTAATCTCGACCAACCTTATTA -> GCTAATCTCGACCAACCTTATTAT
TGATCGATCACGCCAAGACAACAC -> GATCGATCACGCCAAGACAACACG
CAATTAAGTCCGACGGCTCGACCC -> AATTAAGTCCGACGGCTCGACCCG
GGCACACACCGAAAACATGGTAAA -> GCACACACCGAAAACATGGTAAAA
CTAGTGACAAGTGTTCATCTCACC -> TAGTGACAAGTGTTCATCTCACCA
AATAATTCCGCAGATTAAATATTG -> ATAATTCCGCAGATTAAATATTGC
TAACACAGGAAGTTACCCAAAATA -> AACACAGGAAGTTACCCAAAATAC
CCTTAAGTCACGGGGGGTGCATAG -> CTTAAGTCACGGGGGGTGCATAGC
ACGTAGCCTCCCTTAAGTCACGGG -> CGTAGCCTCCCTTAAGTCACGGGG
GCACGTTTCGAAACTATATGCCTT -> CACGTTTCGAAACTATATGCCTTC
GTTCTGGAATCGTGGAGGTCACGC -> TTCTGGAATCGTGGAGGTCACGCT
AGATTAAATATTGCTAAACCCAAG -> GATTAAATATTGCTAAACCCAAGA
AGCACGGAGACGGCGGCAATATCT -> GCACGGAGACGGCGGCAATATCTC
TGTCAATGTTCCATCGTATATCGT -> GTCAATGTTCCATCGTATATCGTA
TCTCGTTGAATAATTCCGCAGATT -> CTCGTTGAATAATTCCGCAGATTA
GACGGGACGATGTTGCCATCAATT -> ACGGGACGATGTTGCCATCAATTC
CAGTTCCGCTGGAACATGCCAACT -> AGTTCCGCTGGAACATGCCAACTG
GTTGATTCACACATCAAACGTTCG -> TTGATTCACACATCAAACGTTCGT
AGTTCAAACGATAATCTACGTCCC -> GTTCAAACGATAATCTACGTCCCT
ACATCAAACGTTCGTGCCGCTGAG -> CATCAAACGTTCGTGCCGCTGAGC
AGCTTAGTACGTCCGCTAATCTCG -> GCTTAGTACGTCCGCTAATCTCGA
ACGTATCGCTTTGTTGAGCACGGA -> CGTATCGCTTTGTTGAGCACGGAG
TCGAGACCCTCCCTGCCTGCCTCG -> CGAGACCCTCCCTGCCTGCCTCGA
ACACCGGATCGAGCGACTCAGATG -> CACCGGATCGAGCGACTCAGATGT
TGCCTGCCTCGAGTTGTCTCTAAG -> GCCTGCCTCGAGTTGTCTCTAAGC
ACCAGCCCGCTCTCTCGCGTGGCA -> CCAGCCCGCTCTCTCGCGTGGCAA
ATAGAGCCTGATTCTAGACCAATT -> TAGAGCCTGATTCTAGACCAATTA
TCTCAGGCTAGAGGCAACAGTTTG -> CTCAGGCTAGAGGCAACAGTTTGG
AGTCATGGAACGTCCTTCACTCCG -> GTCATGGAACGTCCTTCACTCCGC
CTATAGAGCCTGATTCTAGACCAA -> TATAGAGCCTGATTCTAGACCAAT
GGACACTGCCGCCCGGCACGCGGT -> GACACTGCCGCCCGGCACGCGGTA
GCAGATTTACGAGAGCTTAGTACG -> CAGATTTACGAGAGCTTAGTACGT
AACATGCCAACTGAGTTAGTGGCC -> ACATGCCAACTGAGTTAGTGGCCG
TGTCAACCTACCGTTGATTCACAC -> GTCAACCTACCGTTGATTCACACA
ACCCTCCCTGCCTGCCTCGAGTTG -> CCCTCCCTGCCTGCCTCGAGTTGT
TGGCCTAACCAGGATCTCTCTAAA -> GGCCTAACCAGGATCTCTCTAAAA
ATTACCTTTGAGCAGCTCGGTGAG -> TTACCTTTGAGCAGCTCGGTGAGT
CAGGATCTCTCTAAAATCCTTGCA -> AGGATCTCTCTAAAATCCTTGCAC
GTGTCAAATCAGCATGATCGCAGG -> TGTCAAATCAGCATGATCGCAGGT
ACACTCTCGTTGAATAATTCCGCA -> CACTCTCGTTGAATAATTCCGCAG
ACGAGAGCTTAGTACGTCCGCTAA -> CGAGAGCTTAGTACGTCCGCTAAT
CAGCAGATTTACGAGAGCTTAGTA -> AGCAGATTTACGAGAGCTTAGTAC
TTGAGCAGCTCGGTGAGTGTCGCG -> TGAGCAGCTCGGTGAGTGTCGCGG
CTTAACACAGGAAGTTACCCAAAA -> TTAACACAGGAAGTTACCCAAAAT
AAGCAAGTCATGGAACGTCCTTCA -> AGCAAGTCATGGAACGTCCTTCAC
TCTCAGTGTTATGCTCTGAGTTAG -> CTCAGTGTTATGCTCTGAGTTAGC
AACGCCTGTTGTGCCAGTTCAAAC -> ACGCCTGTTGTGCCAGTTCAAACG
GGTCAGATCCAGGTATTTGTGTCA -> GTCAGATCCAGGTATTTGTGTCAA
ACCATGGACACAGATCGATGCACG -> CCATGGACACAGATCGATGCACGT
AATCGTAGAGAGCCCTGTGGCCCC -> ATCGTAGAGAGCCCTGTGGCCCCC
CGGCACTAGTGACAAGTGTTCATC -> GGCACTAGTGACAAGTGTTCATCT
TACAAGAGTTAGTTTAACGTATCG -> ACAAGAGTTAGTTTAACGTATCGC
CCCGCTCTCTCGCGTGGCAAATTG -> CCGCTCTCTCGCGTGGCAAATTGC
GCGGCAATATCTCAGGCTAGAGGC -> CGGCAATATCTCAGGCTAGAGGCA
TCAGGTAGGTACCGCGGACCTCTA -> CAGGTAGGTACCGCGGACCTCTAC
CTAGCCGCTGTCAACCTACCGTTG -> TAGCCGCTGTCAACCTACCGTTGA
CCCGACACGGCTGCAAGAACGCCT -> CCGACACGGCTGCAAGAACGCCTG
CATCGAATCTGTTATGTCTGGCCT -> ATCGAATCTGTTATGTCTGGCCTA
ACATGCCAACTGAGTTAGTGGCCG -> CATGCCAACTGAGTTAGTGGCCGA
CCATCAATTCTGCAGGTTTTAATA -> CATCAATTCTGCAGGTTTTAATAG
CCCAAGACGGGACGATGTTGCCAT -> CCAAGACGGGACGATGTTGCCATC
TTTGTTGAGCACGGAGACGGCGGC -> TTGTTGAGCACGGAGACGGCGGCA
GCTGGTCAGATCCAGGTATTTGTG -> CTGGTCAGATCCAGGTATTTGTGT
AAGTCACGGGGGGTGCATAGCAAC -> AGTCACGGGGGGTGCATAGCAACT
TGAAGACCGGACACTGCCGCCCGG -> GAAGACCGGACACTGCCGCCCGGC
AATTCCGCAGATTAAATATTGCTA -> ATTCCGCAGATTAAATATTGCTAA
TCTTTGGTAAGTGTAGCCTGTAAC -> CTTTGGTAAGTGTAGCCTGTAACG
CGTCCTTCACTCCGCAACGGCACA -> GTCCTTCACTCCGCAACGGCACAC
CCCGCCACTAGCCGCTGTCAACCT -> CCGCCACTAGCCGCTGTCAACCTA
CTCTGTCGGCCTTACTGTTCAGAT -> TCTGTCGGCCTTACTGTTCAGATC
GTAGTCCGATGGACCAGATCTCTA -> TAGTCCGATGGACCAGATCTCTAT
ACATGGTAAAAATGCCAAACATGC -> CATGGTAAAAATGCCAAACATGCG
GTCTTTGGTAAGTGTAGCCTGTAA -> TCTTTGGTAAGTGTAGCCTGTAAC
TGTACAAAGGTTGCCTCTGTGTAA -> GTACAAAGGTTGCCTCTGTGTAAC
ACCACCCTACAAGAGTTAGTTTAA -> CCACCCTACAAGAGTTAGTTTAAC
CACAGTTCCGCTGGAACATGCCAA -> ACAGTTCCGCTGGAACATGCCAAC
ATGTTCCATCGTATATCGTAGGGA -> TGTTCCATCGTATATCGTAGGGAA
GAGTGTCAAACAGCAGATTTACGA -> AGTGTCAAACAGCAGATTTACGAG
GTTAGTTTAACGTATCGCTTTGTT -> TTAGTTTAACGTATCGCTTTGTTG
CGTAGCAGCAGAATGGGTGTCGAA -> GTAGCAGCAGAATGGGTGTCGAAG
TATGGTCTCGATTGTACAAAGGTT -> ATGGTCTCGATTGTACAAAGGTTG
CGTTCGTGCCGCTGAGCAACGGAC -> GTTCGTGCCGCTGAGCAACGGACC
CGTAAATTTGTTACACCCTTCCGG -> GTAAATTTGTTACACCCTTCCGGC
AGACGGCGGCAATATCTCAGGCTA -> GACGGCGGCAATATCTCAGGCTAG
TACAAAGGTTGCCTCTGTGTAACG -> ACAAAGGTTGCCTCTGTGTAACGG
TAAATATTGCTAAACCCAAGACGG -> AAATATTGCTAAACCCAAGACGGG
GGAGACGGCGGCAATATCTCAGGC -> GAGACGGCGGCAATATCTCAGGCT
TTTTAATAGTGATACTCCGAACGT -> TTTAATAGTGATACTCCGAACGTA
CTATCCCCCGTAAATTTGTTACAC -> TATCCCCCGTAAATTTGTTACACC
TTCATCTCACCAATACTACAGGTC -> TCATCTCACCAATACTACAGGTCG
CAAAATACATAGCAGGACCCAATA -> AAAATACATAGCAGGACCCAATAT
GTCACGGGGGGTGCATAGCAACTT -> TCACGGGGGGTGCATAGCAACTTT
TCATTATCGGCCTGCACCAGTTTA -> CATTATCGGCCTGCACCAGTTTAA
GCACAGTTCCGCTGGAACATGCCA -> CACAGTTCCGCTGGAACATGCCAA
CAGCTCGGTGAGTGTCGCGGTTTG -> AGCTCGGTGAGTGTCGCGGTTTGT
GATTAAATATTGCTAAACCCAAGA -> ATTAAATATTGCTAAACCCAAGAC
AGGCTGATTTATAAGCCAGACCGA -> GGCTGATTTATAAGCCAGACCGAA
GCCAACTGAGTTAGTGGCCGATTT -> CCAACTGAGTTAGTGGCCGATTTT
GAATAGTGTCAAGTCACCGTCTAA -> AATAGTGTCAAGTCACCGTCTAAT
GAGTTGTCTCTAAGCATCCCTCCA -> AGTTGTCTCTAAGCATCCCTCCAT
ACCCTCTCAGTGTTATGCTCTGAG -> CCCTCTCAGTGTTATGCTCTGAGT
TGTCTCTAAGCATCCCTCCATTAC -> GTCTCTAAGCATCCCTCCATTACG
ACAGCAGATTTACGAGAGCTTAGT -> CAGCAGATTTACGAGAGCTTAGTA
CACGCGGTAGTACCTATCCCCCGT -> ACGCGGTAGTACCTATCCCCCGTA
TGACCCTCTCAGTGTTATGCTCTG -> GACCCTCTCAGTGTTATGCTCTGA
ACCTTATTATCCCGTCTTTGAATG -> CCTTATTATCCCGTCTTTGAATGA
TATATCGTAGGGAATAGTGTCAAG -> ATATCGTAGGGAATAGTGTCAAGT
CATGGTAAAAATGCCAAACATGCG -> ATGGTAAAAATGCCAAACATGCGC
TTCCACGCTTAACACAGGAAGTTA -> TCCACGCTTAACACAGGAAGTTAC
GAGGCTGATTTATAAGCCAGACCG -> AGGCTGATTTATAAGCCAGACCGA
GGATAATCGTAGAGAGCCCTGTGG -> GATAATCGTAGAGAGCCCTGTGGC
AGTGTTCATCTCACCAATACTACA -> GTGTTCATCTCACCAATACTACAG
AGCCTGATTCTAGACCAATTAAGT -> GCCTGATTCTAGACCAATTAAGTC
ACGCGGTAGTACCTATCCCCCGTA -> CGCGGTAGTACCTATCCCCCGTAA
CACACGCAGCCCTGACTCGAGCGC -> ACACGCAGCCCTGACTCGAGCGCT
TGCTAAACCCAAGACGGGACGATG -> GCTAAACCCAAGACGGGACGATGT
ATTCTGCAGGTTTTAATAGTGATA -> TTCTGCAGGTTTTAATAGTGATAC
ATATTGCTAAACCCAAGACGGGAC -> TATTGCTAAACCCAAGACGGGACG
TACTATGGTCTCGATTGTACAAAG -> ACTATGGTCTCGATTGTACAAAGG
TCAGTGTTATGCTCTGAGTTAGCC -> CAGTGTTATGCTCTGAGTTAGCCG
ATCGAATCTGTTATGTCTGGCCTA -> TCGAATCTGTTATGTCTGGCCTAA
CGTTGAATAATTCCGCAGATTAAA -> GTTGAATAATTCCGCAGATTAAAT
CAGATCGATGCACGTTTCGAAACT -> AGATCGATGCACGTTTCGAAACTA
CACGGCTGCAAGAACGCCTGTTGT -> ACGGCTGCAAGAACGCCTGTTGTG
TGTCGCGGTTTGTTCTCAAAGGGC -> GTCGCGGTTTGTTCTCAAAGGGCG
GGTCACGCTCAGGTAGGTACCGCG -> GTCACGCTCAGGTAGGTACCGCGG
AGCCCTGACTCGAGCGCTGTCGTA -> GCCCTGACTCGAGCGCTGTCGTAG
TAGTACCTATCCCCCGTAAATTTG -> AGTACCTATCCCCCGTAAATTTGT
GTCATGTGAGGGAACAGGCAGGTC -> TCATGTGAGGGAACAGGCAGGTCA
GCGGTAGTACCTATCCCCCGTAAA -> CGGTAGTACCTATCCCCCGTAAAT
AATGGGTGTCGAAGCCTCTGTCGG -> ATGGGTGTCGAAGCCTCTGTCGGC
CGACTAAATCGGCACTAGTGACAA -> GACTAAATCGGCACTAGTGACAAG
TCACCGTCTAATGTTACCTCGACC -> CACCGTCTAATGTTACCTCGACCA
ATCGTAGAGAGCCCTGTGGCCCCC -> TCGTAGAGAGCCCTGTGGCCCCCA
CAGTTCAAACGATAATCTACGTCC -> AGTTCAAACGATAATCTACGTCCC
CCTCTCAGTGTTATGCTCTGAGTT -> CTCTCAGTGTTATGCTCTGAGTTA
ACACCGAAAACATGGTAAAAATGC -> CACCGAAAACATGGTAAAAATGCC
TTCTCACACGCAGCCCTGACTCGA -> TCTCACACGCAGCCCTGACTCGAG
CCAGGATCTCTCTAAAATCCTTGC -> CAGGATCTCTCTAAAATCCTTGCA
CGCTTAACACAGGAAGTTACCCAA -> GCTTAACACAGGAAGTTACCCAAA
CAGACCGAACATTACCTTTGAGCA -> AGACCGAACATTACCTTTGAGCAG
CTGAGCAACGGACCACCCTACAAG -> TGAGCAACGGACCACCCTACAAGA
ATTTCTTATTCTTTCTCACACGCA -> TTTCTTATTCTTTCTCACACGCAG
TTAACGTATCGCTTTGTTGAGCAC -> TAACGTATCGCTTTGTTGAGCACG
CACTCTCGTTGAATAATTCCGCAG -> ACTCTCGTTGAATAATTCCGCAGA
TCAAACGTTCGTGCCGCTGAGCAA -> CAAACGTTCGTGCCGCTGAGCAAC
ATTACGTCCCACGACTTCTCATGG -> TTACGTCCCACGACTTCTCATGGA
GATAATCTACGTCCCTCGCGCCAC -> ATAATCTACGTCCCTCGCGCCACG
CCTGACTCGAGCGCTGTCGTAGCA -> CTGACTCGAGCGCTGTCGTAGCAG
TTTCCACGCTTAACACAGGAAGTT -> TTCCACGCTTAACACAGGAAGTTA
ACCCTTCCGGCTGGTCAGATCCAG -> CCCTTCCGGCTGGTCAGATCCAGG
TTAGGAGTGTCAAACAGCAGATTT -> TAGGAGTGTCAAACAGCAGATTTA
CTCTCTAAAATCCTTGCACAGTTC -> TCTCTAAAATCCTTGCACAGTTCC
GAATGGGTGTCGAAGCCTCTGTCG -> AATGGGTGTCGAAGCCTCTGTCGG
CCCGTCTTTGAATGAGGCTGATTT -> CCGTCTTTGAATGAGGCTGATTTA
TCGTTGAATAATTCCGCAGATTAA -> CGTTGAATAATTCCGCAGATTAAA
TCACGCCAAGACAACACGTCGAAT -> CACGCCAAGACAACACGTCGAATA
ATGTAAGTCTATAGCAAGGGCACG -> TGTAAGTCTATAGCAAGGGCACGG
CCTTACTGTTCAGATCGAGACGTA -> CTTACTGTTCAGATCGAGACGTAG
CAAGAACGCCTGTTGTGCCAGTTC -> AAGAACGCCTGTTGTGCCAGTTCA
CCAAGGTGTCAATGTTCCATCGTA -> CAAGGTGTCAATGTTCCATCGTAT
GACATCGAATCTGTTATGTCTGGC -> ACATCGAATCTGTTATGTCTGGCC
AGCCGATATGCTTACAACTCGCAC -> GCCGATATGCTTACAACTCGCACT
AGATCGAGACGTAGCCTCCCTTAA -> GATCGAGACGTAGCCTCCCTTAAG
AGCATCCCTCCATTACGTCCCACG -> GCATCCCTCCATTACGTCCCACGA
TGCCGCTGAGCAACGGACCACCCT -> GCCGCTGAGCAACGGACCACCCTA
GTGCTATTCAGACTGCCCCAGATC -> TGCTATTCAGACTGCCCCAGATCC
CAATATCTCAGGCTAGAGGCAACA -> AATATCTCAGGCTAGAGGCAACAG
TCCCACGACTTCTCATGGAAGATG -> CCCACGACTTCTCATGGAAGATGC
CGACCCGGTAGTCCGATGGACCAG -> GACCCGGTAGTCCGATGGACCAGA
CAAGTGTTCATCTCACCAATACTA -> AAGTGTTCATCTCACCAATACTAC
TAAGTCCGACGGCTCGACCCGGTA -> AAGTCCGACGGCTCGACCCGGTAG
AACATGGTAAAAATGCCAAACATG -> ACATGGTAAAAATGCCAAACATGC
GTCATGGAACGTCCTTCACTCCGC -> TCATGGAACGTCCTTCACTCCGCA
CCAGATCTCTATAGTGAAGACCGG -> CAGATCTCTATAGTGAAGACCGGA
CTGAGTTAGCCGATATGCTTACAA -> TGAGTTAGCCGATATGCTTACAAC
GCGGACCTCTACCGCACAATGGCA -> CGGACCTCTACCGCACAATGGCAG
ACATGCCGGTTCGAGACCCTCCCT -> CATGCCGGTTCGAGACCCTCCCTG
TCGAAGCCTCTGTCGGCCTTACTG -> CGAAGCCTCTGTCGGCCTTACTGT
GGCTGCAAGAACGCCTGTTGTGCC -> GCTGCAAGAACGCCTGTTGTGCCA
GTGACGTGAAACCACGTCCTATAG -> TGACGTGAAACCACGTCCTATAGA
ATCGTGGAGGTCACGCTCAGGTAG -> TCGTGGAGGTCACGCTCAGGTAGG
CGTCCGCTAATCTCGACCAACCTT -> GTCCGCTAATCTCGACCAACCTTA
AGGCTAGAGGCAACAGTTTGGTAT -> GGCTAGAGGCAACAGTTTGGTATT
CATGCGCGAGGTCAAAGGGGTAAA -> ATGCGCGAGGTCAAAGGGGTAAAA
AAAGGGGTAAAACACCCTGATATT -> AAGGGGTAAAACACCCTGATATTA
ATTAAATATTGCTAAACCCAAGAC -> TTAAATATTGCTAAACCCAAGACG
CGAATCTGTTATGTCTGGCCTAAC -> GAATCTGTTATGTCTGGCCTAACC
CGGATCGAGCGACTCAGATGTAAG -> GGATCGAGCGACTCAGATGTAAGT
TCAACCTACCGTTGATTCACACAT -> CAACCTACCGTTGATTCACACATC
CGCTGTCAACCTACCGTTGATTCA -> GCTGTCAACCTACCGTTGATTCAC
TCGCTCATCCAAGGTGTCAATGTT -> CGCTCATCCAAGGTGTCAATGTTC
ACGTAATGGAGAGGTATTTCTTAT -> CGTAATGGAGAGGTATTTCTTATT
CTAACCAGGATCTCTCTAAAATCC -> TAACCAGGATCTCTCTAAAATCCT
TTTCTTATTCTTTCTCACACGCAG -> TTCTTATTCTTTCTCACACGCAGC
TACGGCCCTCATTATCGGCCTGCA -> ACGGCCCTCATTATCGGCCTGCAC
TTACCTTTGAGCAGCTCGGTGAGT -> TACCTTTGAGCAGCTCGGTGAGTG
GTCAAAGGGGTAAAACACCCTGAT -> TCAAAGGGGTAAAACACCCTGATA
CTACCAAGGAGCCACTTCGAATAA -> TACCAAGGAGCCACTTCGAATAAT
ACGGGTGACCGTTCTGGAATCGTG -> CGGGTGACCGTTCTGGAATCGTGG
CTCAACCGTTTGTCTTTGGTAAGT -> TCAACCGTTTGTCTTTGGTAAGTG
TCGAGACGTAGCCTCCCTTAAGTC -> CGAGACGTAGCCTCCCTTAAGTCA
AAGATAACACGAATTGCGCTTAAC -> AGATAACACGAATTGCGCTTAACC
ATTGCGCTTAACCGTTTCTGCAAC -> TTGCGCTTAACCGTTTCTGCAACT
CGTCCCCAATAGGTGACGTGAAAC -> GTCCCCAATAGGTGACGTGAAACC
CGTGGAGGTCACGCTCAGGTAGGT -> GTGGAGGTCACGCTCAGGTAGGTA
CCGAACATTACCTTTGAGCAGCTC -> CGAACATTACCTTTGAGCAGCTCG
TATTATCCCGTCTTTGAATGAGGC -> ATTATCCCGTCTTTGAATGAGGCT
ACACCGAAGTTTTGGAGGTAAGAT -> CACCGAAGTTTTGGAGGTAAGATA
CTGTCAACCTACCGTTGATTCACA -> TGTCAACCTACCGTTGATTCACAC
AGTCCGATGGACCAGATCTCTATA -> GTCCGATGGACCAGATCTCTATAG
CTCGGTGAGTGTCGCGGTTTGTTC -> TCGGTGAGTGTCGCGGTTTGTTCT
ACTTCTCATGGAAGATGCTACCAA -> CTTCTCATGGAAGATGCTACCAAG
CCCTTAAGTCACGGGGGGTGCATA -> CCTTAAGTCACGGGGGGTGCATAG
GTGAAGACCGGACACTGCCGCCCG -> TGAAGACCGGACACTGCCGCCCGG
ACCGTTTGTCTTTGGTAAGTGTAG -> CCGTTTGTCTTTGGTAAGTGTAGC
GTTTAAGGATCCGATCCGTCCCCA -> TTTAAGGATCCGATCCGTCCCCAA
TGACGTGAAACCACGTCCTATAGA -> GACGTGAAACCACGTCCTATAGAG
AGCAGGACCCAATATCTACAGGGG -> GCAGGACCCAATATCTACAGGGGG
CCCAAAGCAAGTCATGGAACGTCC -> CCAAAGCAAGTCATGGAACGTCCT
ACACTGCCGCCCGGCACGCGGTAG -> CACTGCCGCCCGGCACGCGGTAGT
GCATCCCTCCATTACGTCCCACGA -> CATCCCTCCATTACGTCCCACGAC
TACAACTCGCACTTCGGACATCGA -> ACAACTCGCACTTCGGACATCGAA
CACTCCGCAACGGCACACACCGAA -> ACTCCGCAACGGCACACACCGAAA
CTCTCTCGCGTGGCAAATTGCTCG -> TCTCTCGCGTGGCAAATTGCTCGC
GCTCAGGTAGGTACCGCGGACCTC -> CTCAGGTAGGTACCGCGGACCTCT
ATAACACGAATTGCGCTTAACCGT -> TAACACGAATTGCGCTTAACCGTT
GATCTCTATAGTGAAGACCGGACA -> ATCTCTATAGTGAAGACCGGACAC
AATCTACGTCCCTCGCGCCACGAG -> ATCTACGTCCCTCGCGCCACGAGC
ATCACGCCAAGACAACACGTCGAA -> TCACGCCAAGACAACACGTCGAAT
TCTTTCTCACACGCAGCCCTGACT -> CTTTCTCACACGCAGCCCTGACTC
AGACCGAACATTACCTTTGAGCAG -> GACCGAACATTACCTTTGAGCAGC
GGACCCAATATCTACAGGGGGCGG -> GACCCAATATCTACAGGGGGCGGG
CCTTCGTTAACTTATGGCTTTCCA -> CTTCGTTAACTTATGGCTTTCCAC
GCCTGCACCAGTTTAAGGATCCGA -> CCTGCACCAGTTTAAGGATCCGAT
CCTGCCTGCCTCGAGTTGTCTCTA -> CTGCCTGCCTCGAGTTGTCTCTAA
CGGCCTTACTGTTCAGATCGAGAC -> GGCCTTACTGTTCAGATCGAGACG
ACTGCCGCCCGGCACGCGGTAGTA -> CTGCCGCCCGGCACGCGGTAGTAC
GATCGATGCACGTTTCGAAACTAT -> ATCGATGCACGTTTCGAAACTATA
ACGACTTCTCATGGAAGATGCTAC -> CGACTTCTCATGGAAGATGCTACC
ACATGCGCGAGGTCAAAGGGGTAA -> CATGCGCGAGGTCAAAGGGGTAAA
AACACAGGAAGTTACCCAAAATAC -> ACACAGGAAGTTACCCAAAATACA
GATCCCGCCACTAGCCGCTGTCAA -> ATCCCGCCACTAGCCGCTGTCAAC
AATGTTCCATCGTATATCGTAGGG -> ATGTTCCATCGTATATCGTAGGGA
TATGCTCTGAGTTAGCCGATATGC -> ATGCTCTGAGTTAGCCGATATGCT
CTATGGTCTCGATTGTACAAAGGT -> TATGGTCTCGATTGTACAAAGGTT
CTATAGTGAAGACCGGACACTGCC -> TATAGTGAAGACCGGACACTGCCG
TCCGCTAATCTCGACCAACCTTAT -> CCGCTAATCTCGACCAACCTTATT
AGCCTGTAACGCTGTACACCGGAT -> GCCTGTAACGCTGTACACCGGATC
GGCTCAACCGTTTGTCTTTGGTAA -> GCTCAACCGTTTGTCTTTGGTAAG
CGTTAACTTATGGCTTTCCACGCT -> GTTAACTTATGGCTTTCCACGCTT
ATGGTCTCGATTGTACAAAGGTTG -> TGGTCTCGATTGTACAAAGGTTGC
ATCGAGCGACTCAGATGTAAGTCT -> TCGAGCGACTCAGATGTAAGTCTA
GATGCTACCAAGGAGCCACTTCGA -> ATGCTACCAAGGAGCCACTTCGAA
TTGTCTTTGGTAAGTGTAGCCTGT -> TGTCTTTGGTAAGTGTAGCCTGTA
TAAATTTGTTACACCCTTCCGGCT -> AAATTTGTTACACCCTTCCGGCTG
CTTTGAGCAGCTCGGTGAGTGTCG -> TTTGAGCAGCTCGGTGAGTGTCGC
CTACACTCTCGTTGAATAATTCCG -> TACACTCTCGTTGAATAATTCCGC
GATATTATTACTACATGCCGGTTC -> ATATTATTACTACATGCCGGTTCG
AACACGAATTGCGCTTAACCGTTT -> ACACGAATTGCGCTTAACCGTTTC
CGACGGCTCGACCCGGTAGTCCGA -> GACGGCTCGACCCGGTAGTCCGAT
TATAGCAAGGGCACGGATAATCGT -> ATAGCAAGGGCACGGATAATCGTA
CTGGAACATGCCAACTGAGTTAGT -> TGGAACATGCCAACTGAGTTAGTG
GTAAAAATGCCAAACATGCGCGAG -> TAAAAATGCCAAACATGCGCGAGG
GCGTGGCAAATTGCTCGCTCATCC -> CGTGGCAAATTGCTCGCTCATCCA
TTTGAGCAGCTCGGTGAGTGTCGC -> TTGAGCAGCTCGGTGAGTGTCGCG
AGTGTAGCCTGTAACGCTGTACAC -> GTGTAGCCTGTAACGCTGTACACC
CCCTGACTCGAGCGCTGTCGTAGC -> CCTGACTCGAGCGCTGTCGTAGCA
CTCACCAATACTACAGGTCGTGGT -> TCACCAATACTACAGGTCGTGGTC
AACTTATGGCTTTCCACGCTTAAC -> ACTTATGGCTTTCCACGCTTAACA
TTTGGTAAGTGTAGCCTGTAACGC -> TTGGTAAGTGTAGCCTGTAACGCT
GCCACGAGCTACAACACACCGAAG -> CCACGAGCTACAACACACCGAAGT
TATTATTACTACATGCCGGTTCGA -> ATTATTACTACATGCCGGTTCGAG
CCGCCACTAGCCGCTGTCAACCTA -> CGCCACTAGCCGCTGTCAACCTAC
GAAACCACGTCCTATAGAGCCTGA -> AAACCACGTCCTATAGAGCCTGAT
CACACCGAAGTTTTGGAGGTAAGA -> ACACCGAAGTTTTGGAGGTAAGAT
ATCGAGACGTAGCCTCCCTTAAGT -> TCGAGACGTAGCCTCCCTTAAGTC
CAAAGGGGTAAAACACCCTGATAT -> AAAGGGGTAAAACACCCTGATATT
CTAGAGGCAACAGTTTGGTATTAG -> TAGAGGCAACAGTTTGGTATTAGG
CAACCTACCGTTGATTCACACATC -> AACCTACCGTTGATTCACACATCA
TGTTATGTCTGGCCTAACCAGGAT -> GTTATGTCTGGCCTAACCAGGATC
CTAAGCATCCCTCCATTACGTCCC -> TAAGCATCCCTCCATTACGTCCCA
AGACCGGACACTGCCGCCCGGCAC -> GACCGGACACTGCCGCCCGGCACG
GAACGTAATGGAGAGGTATTTCTT -> AACGTAATGGAGAGGTATTTCTTA
ATCGCTTTGTTGAGCACGGAGACG -> TCGCTTTGTTGAGCACGGAGACGG
ACCGCACAATGGCAGTAGAATTGT -> CCGCACAATGGCAGTAGAATTGTG
TGCAGGTTTTAATAGTGATACTCC -> GCAGGTTTTAATAGTGATACTCCG
CCTGCCTCGAGTTGTCTCTAAGCA -> CTGCCTCGAGTTGTCTCTAAGCAT
AAGGTTGCCTCTGTGTAACGGGAC -> AGGTTGCCTCTGTGTAACGGGACC
CCACGACTTCTCATGGAAGATGCT -> CACGACTTCTCATGGAAGATGCTA
CGTCCCTCGCGCCACGAGCTACAA -> GTCCCTCGCGCCACGAGCTACAAC
AGTCACGGGGGGTGCATAGCAACT -> GTCACGGGGGGTGCATAGCAACTT
ACACCCTTCCGGCTGGTCAGATCC -> CACCCTTCCGGCTGGTCAGATCCA
TCGAGTTGTCTCTAAGCATCCCTC -> CGAGTTGTCTCTAAGCATCCCTCC
AGCAACTTTGGCGACTAAATCGGC -> GCAACTTTGGCGACTAAATCGGCA
GGCAATATCTCAGGCTAGAGGCAA -> GCAATATCTCAGGCTAGAGGCAAC
GGCCTTACTGTTCAGATCGAGACG -> GCCTTACTGTTCAGATCGAGACGT
ATTGTGATCGATCACGCCAAGACA -> TTGTGATCGATCACGCCAAGACAA
GGAAGTTACCCAAAATACATAGCA -> GAAGTTACCCAAAATACATAGCAG
CTGATTTATAAGCCAGACCGAACA -> TGATTTATAAGCCAGACCGAACAT
ATGCCGGTTCGAGACCCTCCCTGC -> TGCCGGTTCGAGACCCTCCCTGCC
TCCTTGCACAGTTCCGCTGGAACA -> CCTTGCACAGTTCCGCTGGAACAT
TCGTAGAGAGCCCTGTGGCCCCCA -> CGTAGAGAGCCCTGTGGCCCCCAA
CGTAATGGAGAGGTATTTCTTATT -> GTAATGGAGAGGTATTTCTTATTC
CTTACAACTCGCACTTCGGACATC -> TTACAACTCGCACTTCGGACATCG
GTTTTGGAGGTAAGATAACACGAA -> TTTTGGAGGTAAGATAACACGAAT
TTAGCCGATATGCTTACAACTCGC -> TAGCCGATATGCTTACAACTCGCA
TAGGTACCGCGGACCTCTACCGCA -> AGGTACCGCGGACCTCTACCGCAC
GGATTTGTCATGTGAGGGAACAGG -> GATTTGTCATGTGAGGGAACAGGC
CTAATCTCGACCAACCTTATTATC -> TAATCTCGACCAACCTTATTATCC
GCTTTCCACGCTTAACACAGGAAG -> CTTTCCACGCTTAACACAGGAAGT
CACCCTACAAGAGTTAGTTTAACG -> ACCCTACAAGAGTTAGTTTAACGT
TCTCTCTAAAATCCTTGCACAGTT -> CTCTCTAAAATCCTTGCACAGTTC
CATGGACACAGATCGATGCACGTT -> ATGGACACAGATCGATGCACGTTT
GATGCACGTTTCGAAACTATATGC -> ATGCACGTTTCGAAACTATATGCC
GGTGACGTGAAACCACGTCCTATA -> GTGACGTGAAACCACGTCCTATAG
TATAGAGCCTGATTCTAGACCAAT -> ATAGAGCCTGATTCTAGACCAATT
ATCCTTGCACAGTTCCGCTGGAAC -> TCCTTGCACAGTTCCGCTGGAACA
GCTCTCTCGCGTGGCAAATTGCTC -> CTCTCTCGCGTGGCAAATTGCTCG
AGCAGATTTACGAGAGCTTAGTAC -> GCAGATTTACGAGAGCTTAGTACG
ACCAACCTTATTATCCCGTCTTTG -> CCAACCTTATTATCCCGTCTTTGA
GAGCCTGATTCTAGACCAATTAAG -> AGCCTGATTCTAGACCAATTAAGT
GCCTTACTGTTCAGATCGAGACGT -> CCTTACTGTTCAGATCGAGACGTA
GGAATAGTGTCAAGTCACCGTCTA -> GAATAGTGTCAAGTCACCGTCTAA
ACGGAGACGGCGGCAATATCTCAG -> CGGAGACGGCGGCAATATCTCAGG
TTCTGCAACTGACCCTCTCAGTGT -> TCTGCAACTGACCCTCTCAGTGTT
CAATTCTGCAGGTTTTAATAGTGA -> AATTCTGCAGGTTTTAATAGTGAT
CGATATGCTTACAACTCGCACTTC -> GATATGCTTACAACTCGCACTTCG
TGCCAACTGAGTTAGTGGCCGATT -> GCCAACTGAGTTAGTGGCCGATTT
GATTCTAGACCAATTAAGTCCGAC -> ATTCTAGACCAATTAAGTCCGACG
TGTCATGTGAGGGAACAGGCAGGT -> GTCATGTGAGGGAACAGGCAGGTC
AAATGCCAAACATGCGCGAGGTCA -> AATGCCAAACATGCGCGAGGTCAA
CCTCCCTTAAGTCACGGGGGGTGC -> CTCCCTTAAGTCACGGGGGGTGCA
AAGCCAGACCGAACATTACCTTTG -> AGCCAGACCGAACATTACCTTTGA
TCGGACATCGAATCTGTTATGTCT -> CGGACATCGAATCTGTTATGTCTG
AGGAGTGTCAAACAGCAGATTTAC -> GGAGTGTCAAACAGCAGATTTACG
GGTGTCAATGTTCCATCGTATATC -> GTGTCAATGTTCCATCGTATATCG
GCTGTACACCGGATCGAGCGACTC -> CTGTACACCGGATCGAGCGACTCA
AGGACCCAATATCTACAGGGGGCG -> GGACCCAATATCTACAGGGGGCGG
GTGGCAAATTGCTCGCTCATCCAA -> TGGCAAATTGCTCGCTCATCCAAG
GCAGAATGGGTGTCGAAGCCTCTG -> CAGAATGGGTGTCGAAGCCTCTGT
AGTACTACACTCTCGTTGAATAAT -> GTACTACACTCTCGTTGAATAATT
GACCGAACATTACCTTTGAGCAGC -> ACCGAACATTACCTTTGAGCAGCT
AGAGTTAGTTTAACGTATCGCTTT -> GAGTTAGTTTAACGTATCGCTTTG
CGCCCGGCACGCGGTAGTACCTAT -> GCCCGGCACGCGGTAGTACCTATC
CTAAATCGGCACTAGTGACAAGTG -> TAAATCGGCACTAGTGACAAGTGT
AGCAGCAGAATGGGTGTCGAAGCC -> GCAGCAGAATGGGTGTCGAAGCCT
ATTTGTTACACCCTTCCGGCTGGT -> TTTGTTACACCCTTCCGGCTGGTC
CCTGATTCTAGACCAATTAAGTCC -> CTGATTCTAGACCAATTAAGTCCG
AACGGCACACACCGAAAACATGGT -> ACGGCACACACCGAAAACATGGTA
TCCGCAACGGCACACACCGAAAAC -> CCGCAACGGCACACACCGAAAACA
GACTCAGATGTAAGTCTATAGCAA -> ACTCAGATGTAAGTCTATAGCAAG
TCAAAGGGGTAAAACACCCTGATA -> CAAAGGGGTAAAACACCCTGATAT
AATTTGTTACACCCTTCCGGCTGG -> ATTTGTTACACCCTTCCGGCTGGT
TAGCCGCTGTCAACCTACCGTTGA -> AGCCGCTGTCAACCTACCGTTGAT
TGGTCTCGATTGTACAAAGGTTGC -> GGTCTCGATTGTACAAAGGTTGCC
CAAGACGGGACGATGTTGCCATCA -> AAGACGGGACGATGTTGCCATCAA
AGCCACTTCGAATAATGGCGATGC -> GCCACTTCGAATAATGGCGATGCA
GTAAAACACCCTGATATTATTACT -> TAAAACACCCTGATATTATTACTA
AAGTCTATAGCAAGGGCACGGATA -> AGTCTATAGCAAGGGCACGGATAA
TTGGTAAGTGTAGCCTGTAACGCT -> TGGTAAGTGTAGCCTGTAACGCTG
CAACACACCGAAGTTTTGGAGGTA -> AACACACCGAAGTTTTGGAGGTAA
TACACCCTTCCGGCTGGTCAGATC -> ACACCCTTCCGGCTGGTCAGATCC
TGGAACGTCCTTCACTCCGCAACG -> GGAACGTCCTTCACTCCGCAACGG
TCAATGTTCCATCGTATATCGTAG -> CAATGTTCCATCGTATATCGTAGG
CGATGCACGTTTCGAAACTATATG -> GATGCACGTTTCGAAACTATATGC
GAACGCCTGTTGTGCCAGTTCAAA -> AACGCCTGTTGTGCCAGTTCAAAC
TAAGTCACGGGGGGTGCATAGCAA -> AAGTCACGGGGGGTGCATAGCAAC
TGTTATGCTCTGAGTTAGCCGATA -> GTTATGCTCTGAGTTAGCCGATAT
GACGGCTCGACCCGGTAGTCCGAT -> ACGGCTCGACCCGGTAGTCCGATG
ATCGGCCTGCACCAGTTTAAGGAT -> TCGGCCTGCACCAGTTTAAGGATC
GCAACAGTTTGGTATTAGGAGTGT -> CAACAGTTTGGTATTAGGAGTGTC
TCATCCAAGGTGTCAATGTTCCAT -> CATCCAAGGTGTCAATGTTCCATC
CCGACACGGCTGCAAGAACGCCTG -> CGACACGGCTGCAAGAACGCCTGT
GCAACGGCACACACCGAAAACATG -> CAACGGCACACACCGAAAACATGG
CGTGGCAAATTGCTCGCTCATCCA -> GTGGCAAATTGCTCGCTCATCCAA
TTTGGCGACTAAATCGGCACTAGT -> TTGGCGACTAAATCGGCACTAGTG
AGACTGCCCCAGATCCCGCCACTA -> GACTGCCCCAGATCCCGCCACTAG
ACCCAAAATACATAGCAGGACCCA -> CCCAAAATACATAGCAGGACCCAA
GATCACGCCAAGACAACACGTCGA -> ATCACGCCAAGACAACACGTCGAA
AACGTTCGTGCCGCTGAGCAACGG -> ACGTTCGTGCCGCTGAGCAACGGA
CTGTGTAACGGGACCAGCCCGCTC -> TGTGTAACGGGACCAGCCCGCTCT
TCTGCAGGTTTTAATAGTGATACT -> CTGCAGGTTTTAATAGTGATACTC
CACGGGGGGTGCATAGCAACTTTG -> ACGGGGGGTGCATAGCAACTTTGG
GTGACCGTTCTGGAATCGTGGAGG -> TGACCGTTCTGGAATCGTGGAGGT
GTTATGTCTGGCCTAACCAGGATC -> TTATGTCTGGCCTAACCAGGATCT
AACCCAAGACGGGACGATGTTGCC -> ACCCAAGACGGGACGATGTTGCCA
TAAGCCAGACCGAACATTACCTTT -> AAGCCAGACCGAACATTACCTTTG
TACCTTTGAGCAGCTCGGTGAGTG -> ACCTTTGAGCAGCTCGGTGAGTGT
CAATACTACAGGTCGTGGTCCCGC -> AATACTACAGGTCGTGGTCCCGCT
GCCCTGACTCGAGCGCTGTCGTAG -> CCCTGACTCGAGCGCTGTCGTAGC
AAAATACATAGCAGGACCCAATAT -> AAATACATAGCAGGACCCAATATC
TCGGCCTGCACCAGTTTAAGGATC -> CGGCCTGCACCAGTTTAAGGATCC
AATACTACAGGTCGTGGTCCCGCT -> ATACTACAGGTCGTGGTCCCGCTT
TGAATGAGGCTGATTTATAAGCCA -> GAATGAGGCTGATTTATAAGCCAG
TTGTTGAGCACGGAGACGGCGGCA -> TGTTGAGCACGGAGACGGCGGCAA
ATAATTCCGCAGATTAAATATTGC -> TAATTCCGCAGATTAAATATTGCT
AATCTCGACCAACCTTATTATCCC -> ATCTCGACCAACCTTATTATCCCG
AAACGATAATCTACGTCCCTCGCG -> AACGATAATCTACGTCCCTCGCGC
GTAAGTGTAGCCTGTAACGCTGTA -> TAAGTGTAGCCTGTAACGCTGTAC
AACCGTTTGTCTTTGGTAAGTGTA -> ACCGTTTGTCTTTGGTAAGTGTAG
TCTGTCGGCCTTACTGTTCAGATC -> CTGTCGGCCTTACTGTTCAGATCG
ATGGAACGTCCTTCACTCCGCAAC -> TGGAACGTCCTTCACTCCGCAACG
TCGAATCTGTTATGTCTGGCCTAA -> CGAATCTGTTATGTCTGGCCTAAC
GTCCTTCACTCCGCAACGGCACAC -> TCCTTCACTCCGCAACGGCACACA
GAAAACATGGTAAAAATGCCAAAC -> AAAACATGGTAAAAATGCCAAACA
GCAACTTTGGCGACTAAATCGGCA -> CAACTTTGGCGACTAAATCGGCAC
CTTATGGCTTTCCACGCTTAACAC -> TTATGGCTTTCCACGCTTAACACA
CCGAACGTAATGGAGAGGTATTTC -> CGAACGTAATGGAGAGGTATTTCT
ACACAGATCGATGCACGTTTCGAA -> CACAGATCGATGCACGTTTCGAAA
ATAGTGAAGACCGGACACTGCCGC -> TAGTGAAGACCGGACACTGCCGCC
GTAACGGGACCAGCCCGCTCTCTC -> TAACGGGACCAGCCCGCTCTCTCG
TTGGAGGTAAGATAACACGAATTG -> TGGAGGTAAGATAACACGAATTGC
AGCATGATCGCAGGTGGGTGCAGC -> GCATGATCGCAGGTGGGTGCAGCA
ACCGGACACTGCCGCCCGGCACGC -> CCGGACACTGCCGCCCGGCACGCG
TGGCAAATTGCTCGCTCATCCAAG -> GGCAAATTGCTCGCTCATCCAAGG
TGTCGAAGCCTCTGTCGGCCTTAC -> GTCGAAGCCTCTGTCGGCCTTACT
TTCTTTCTCACACGCAGCCCTGAC -> TCTTTCTCACACGCAGCCCTGACT
CCGATGGACCAGATCTCTATAGTG -> CGATGGACCAGATCTCTATAGTGA
TTCACTCCGCAACGGCACACACCG -> TCACTCCGCAACGGCACACACCGA
ACTAAATCGGCACTAGTGACAAGT -> CTAAATCGGCACTAGTGACAAGTG
TAATCTACGTCCCTCGCGCCACGA -> AATCTACGTCCCTCGCGCCACGAG
CCAATTAAGTCCGACGGCTCGACC -> CAATTAAGTCCGACGGCTCGACCC
AATAGTGTCAAGTCACCGTCTAAT -> ATAGTGTCAAGTCACCGTCTAATG
GGACGATGTTGCCATCAATTCTGC -> GACGATGTTGCCATCAATTCTGCA
TACACTCTCGTTGAATAATTCCGC -> ACACTCTCGTTGAATAATTCCGCA
TACTCCGAACGTAATGGAGAGGTA -> ACTCCGAACGTAATGGAGAGGTAT
CAGATCCAGGTATTTGTGTCAAAT -> AGATCCAGGTATTTGTGTCAAATC
ACGGGACGATGTTGCCATCAATTC -> CGGGACGATGTTGCCATCAATTCT
GACCGGACACTGCCGCCCGGCACG -> ACCGGACACTGCCGCCCGGCACGC
TCGTTAACTTATGGCTTTCCACGC -> CGTTAACTTATGGCTTTCCACGCT
AGACGGGACGATGTTGCCATCAAT -> GACGGGACGATGTTGCCATCAATT
CTTTCTCACACGCAGCCCTGACTC -> TTTCTCACACGCAGCCCTGACTCG
AGATGTAAGTCTATAGCAAGGGCA -> GATGTAAGTCTATAGCAAGGGCAC
CACCCTTCCGGCTGGTCAGATCCA -> ACCCTTCCGGCTGGTCAGATCCAG
ACCAGTTTAAGGATCCGATCCGTC -> CCAGTTTAAGGATCCGATCCGTCC
TCTACCGCACAATGGCAGTAGAAT -> CTACCGCACAATGGCAGTAGAATT
TAACCAGGATCTCTCTAAAATCCT -> AACCAGGATCTCTCTAAAATCCTT
AAATTGCTCGCTCATCCAAGGTGT -> AATTGCTCGCTCATCCAAGGTGTC
GAAACTATATGCCTTCGTTAACTT -> AAACTATATGCCTTCGTTAACTTA
CCTCTGTGTAACGGGACCAGCCCG -> CTCTGTGTAACGGGACCAGCCCGC
GCCGCTGAGCAACGGACCACCCTA -> CCGCTGAGCAACGGACCACCCTAC
AGCCGCTGTCAACCTACCGTTGAT -> GCCGCTGTCAACCTACCGTTGATT
TTTGAATGAGGCTGATTTATAAGC -> TTGAATGAGGCTGATTTATAAGCC
CTTACTGTTCAGATCGAGACGTAG -> TTACTGTTCAGATCGAGACGTAGC
GAAGATGCTACCAAGGAGCCACTT -> AAGATGCTACCAAGGAGCCACTTC
GGCTGGTCAGATCCAGGTATTTGT -> GCTGGTCAGATCCAGGTATTTGTG
TCGTAGCAGCAGAATGGGTGTCGA -> CGTAGCAGCAGAATGGGTGTCGAA
CCTACCGTTGATTCACACATCAAA -> CTACCGTTGATTCACACATCAAAC
CCCTCATTATCGGCCTGCACCAGT -> CCTCATTATCGGCCTGCACCAGTT
CGCCACTAGCCGCTGTCAACCTAC -> GCCACTAGCCGCTGTCAACCTACC
GGGACCAGCCCGCTCTCTCGCGTG -> GGACCAGCCCGCTCTCTCGCGTGG
TATCGGCCTGCACCAGTTTAAGGA -> ATCGGCCTGCACCAGTTTAAGGAT
GGTATTTCTTATTCTTTCTCACAC -> GTATTTCTTATTCTTTCTCACACG
ATAGTGATACTCCGAACGTAATGG -> TAGTGATACTCCGAACGTAATGGA
CAAGAGTTAGTTTAACGTATCGCT -> AAGAGTTAGTTTAACGTATCGCTT
CTGGAATCGTGGAGGTCACGCTCA -> TGGAATCGTGGAGGTCACGCTCAG
TGACAAGTGTTCATCTCACCAATA -> GACAAGTGTTCATCTCACCAATAC
CCTATAGAGCCTGATTCTAGACCA -> CTATAGAGCCTGATTCTAGACCAA
TCACTCCGCAACGGCACACACCGA -> CACTCCGCAACGGCACACACCGAA
TCTCTATAGTGAAGACCGGACACT -> CTCTATAGTGAAGACCGGACACTG
ATGGACACAGATCGATGCACGTTT -> TGGACACAGATCGATGCACGTTTC
CCCTGATATTATTACTACATGCCG -> CCTGATATTATTACTACATGCCGG
TGTGATCGATCACGCCAAGACAAC -> GTGATCGATCACGCCAAGACAACA
TGTCAAATCAGCATGATCGCAGGT -> GTCAAATCAGCATGATCGCAGGTG
ACGAGCTACAACACACCGAAGTTT -> CGAGCTACAACACACCGAAGTTTT
GGAGTGTCAAACAGCAGATTTACG -> GAGTGTCAAACAGCAGATTTACGA
CGGCTCAACCGTTTGTCTTTGGTA -> GGCTCAACCGTTTGTCTTTGGTAA
AGGGAATAGTGTCAAGTCACCGTC -> GGGAATAGTGTCAAGTCACCGTCT
CTATATGCCTTCGTTAACTTATGG -> TATATGCCTTCGTTAACTTATGGC
TGCCATCAATTCTGCAGGTTTTAA -> GCCATCAATTCTGCAGGTTTTAAT
CATGGATTTGTCATGTGAGGGAAC -> ATGGATTTGTCATGTGAGGGAACA
CTGCAACTGACCCTCTCAGTGTTA -> TGCAACTGACCCTCTCAGTGTTAT
TTACGGCCCTCATTATCGGCCTGC -> TACGGCCCTCATTATCGGCCTGCA
TGTTACACCCTTCCGGCTGGTCAG -> GTTACACCCTTCCGGCTGGTCAGA
AAATATTGCTAAACCCAAGACGGG -> AATATTGCTAAACCCAAGACGGGA
ACGTGAAACCACGTCCTATAGAGC -> CGTGAAACCACGTCCTATAGAGCC
TTACTACATGCCGGTTCGAGACCC -> TACTACATGCCGGTTCGAGACCCT
ACAGGAAGTTACCCAAAATACATA -> CAGGAAGTTACCCAAAATACATAG
ACCGAAAACATGGTAAAAATGCCA -> CCGAAAACATGGTAAAAATGCCAA
ATGCTCTGAGTTAGCCGATATGCT -> TGCTCTGAGTTAGCCGATATGCTT
CCCCAAAGCAAGTCATGGAACGTC -> CCCAAAGCAAGTCATGGAACGTCC
AAGAACGCCTGTTGTGCCAGTTCA -> AGAACGCCTGTTGTGCCAGTTCAA
CACTAGCCGCTGTCAACCTACCGT -> ACTAGCCGCTGTCAACCTACCGTT
GCTCGCTCATCCAAGGTGTCAATG -> CTCGCTCATCCAAGGTGTCAATGT
GGGCGGGGCCCGACACGGCTGCAA -> GGCGGGGCCCGACACGGCTGCAAG
CGAGCTACAACACACCGAAGTTTT -> GAGCTACAACACACCGAAGTTTTG
AATCCTTGCACAGTTCCGCTGGAA -> ATCCTTGCACAGTTCCGCTGGAAC
GTCTCTAAGCATCCCTCCATTACG -> TCTCTAAGCATCCCTCCATTACGT
CATTATCGGCCTGCACCAGTTTAA -> ATTATCGGCCTGCACCAGTTTAAG
AGCCAGACCGAACATTACCTTTGA -> GCCAGACCGAACATTACCTTTGAG
AATTCTGCAGGTTTTAATAGTGAT -> ATTCTGCAGGTTTTAATAGTGATA
TGTCGGCCTTACTGTTCAGATCGA -> GTCGGCCTTACTGTTCAGATCGAG
TGGCGACTAAATCGGCACTAGTGA -> GGCGACTAAATCGGCACTAGTGAC
TTCTCATGGAAGATGCTACCAAGG -> TCTCATGGAAGATGCTACCAAGGA
TATGCCTTCGTTAACTTATGGCTT -> ATGCCTTCGTTAACTTATGGCTTT
AAGCCTCTGTCGGCCTTACTGTTC -> AGCCTCTGTCGGCCTTACTGTTCA
GCTCTGAGTTAGCCGATATGCTTA -> CTCTGAGTTAGCCGATATGCTTAC
AGCTCGGTGAGTGTCGCGGTTTGT -> GCTCGGTGAGTGTCGCGGTTTGTT
CTGTTGTGCCAGTTCAAACGATAA -> TGTTGTGCCAGTTCAAACGATAAT
TTACGTCCCACGACTTCTCATGGA -> TACGTCCCACGACTTCTCATGGAA
CGAACGTAATGGAGAGGTATTTCT -> GAACGTAATGGAGAGGTATTTCTT
TATTACTACATGCCGGTTCGAGAC -> ATTACTACATGCCGGTTCGAGACC
TTGTTCTCAAAGGGCGGCTCAACC -> TGTTCTCAAAGGGCGGCTCAACCG
AGGTGACGTGAAACCACGTCCTAT -> GGTGACGTGAAACCACGTCCTATA
CACTTCGAATAATGGCGATGCACG -> ACTTCGAATAATGGCGATGCACGG
CAATATCTACAGGGGGCGGGGCCC -> AATATCTACAGGGGGCGGGGCCCG
GGTGACCGTTCTGGAATCGTGGAG -> GTGACCGTTCTGGAATCGTGGAGG
TCCCGCCACTAGCCGCTGTCAACC -> CCCGCCACTAGCCGCTGTCAACCT
TTTCGAAACTATATGCCTTCGTTA -> TTCGAAACTATATGCCTTCGTTAA
TCCCCAATAGGTGACGTGAAACCA -> CCCCAATAGGTGACGTGAAACCAC
TCCTATAGAGCCTGATTCTAGACC -> CCTATAGAGCCTGATTCTAGACCA
CTAAAATCCTTGCACAGTTCCGCT -> TAAAATCCTTGCACAGTTCCGCTG
ACGTCCGCTAATCTCGACCAACCT -> CGTCCGCTAATCTCGACCAACCTT
ACGGCCCTCATTATCGGCCTGCAC -> CGGCCCTCATTATCGGCCTGCACC
ATGTCTGGCCTAACCAGGATCTCT -> TGTCTGGCCTAACCAGGATCTCTC
TCAACCGTTTGTCTTTGGTAAGTG -> CAACCGTTTGTCTTTGGTAAGTGT
ACAGTTTGGTATTAGGAGTGTCAA -> CAGTTTGGTATTAGGAGTGTCAAA
TCGCGGTTTGTTCTCAAAGGGCGG -> CGCGGTTTGTTCTCAAAGGGCGGC
GGAGCCACTTCGAATAATGGCGAT -> GAGCCACTTCGAATAATGGCGATG
GAGCGACTCAGATGTAAGTCTATA -> AGCGACTCAGATGTAAGTCTATAG
GTACACCGGATCGAGCGACTCAGA -> TACACCGGATCGAGCGACTCAGAT
GGGCCCGACACGGCTGCAAGAACG -> GGCCCGACACGGCTGCAAGAACGC
ACAACTCGCACTTCGGACATCGAA -> CAACTCGCACTTCGGACATCGAAT
GGCACTAGTGACAAGTGTTCATCT -> GCACTAGTGACAAGTGTTCATCTC
CTGCAAGAACGCCTGTTGTGCCAG -> TGCAAGAACGCCTGTTGTGCCAGT
GTGTTATGCTCTGAGTTAGCCGAT -> TGTTATGCTCTGAGTTAGCCGATA
ACAAGTGTTCATCTCACCAATACT -> CAAGTGTTCATCTCACCAATACTA
CACCGGATCGAGCGACTCAGATGT -> ACCGGATCGAGCGACTCAGATGTA
TCAAACAGCAGATTTACGAGAGCT -> CAAACAGCAGATTTACGAGAGCTT
GCACGGAGACGGCGGCAATATCTC -> CACGGAGACGGCGGCAATATCTCA
GTTTGTCTTTGGTAAGTGTAGCCT -> TTTGTCTTTGGTAAGTGTAGCCTG
AAAGGTTGCCTCTGTGTAACGGGA -> AAGGTTGCCTCTGTGTAACGGGAC
CGTGCCGCTGAGCAACGGACCACC -> GTGCCGCTGAGCAACGGACCACCC
TTGCGCTTAACCGTTTCTGCAACT -> TGCGCTTAACCGTTTCTGCAACTG
CTTGCACAGTTCCGCTGGAACATG -> TTGCACAGTTCCGCTGGAACATGC
GTCCGCTAATCTCGACCAACCTTA -> TCCGCTAATCTCGACCAACCTTAT
ATATCTACAGGGGGCGGGGCCCGA -> TATCTACAGGGGGCGGGGCCCGAC
GCCTAACCAGGATCTCTCTAAAAT -> CCTAACCAGGATCTCTCTAAAATC
GTATTTCTTATTCTTTCTCACACG -> TATTTCTTATTCTTTCTCACACGC
TGGATTTGTCATGTGAGGGAACAG -> GGATTTGTCATGTGAGGGAACAGG
ATAGTGTCAAGTCACCGTCTAATG -> TAGTGTCAAGTCACCGTCTAATGT
CGATAATCTACGTCCCTCGCGCCA -> GATAATCTACGTCCCTCGCGCCAC
GGGCACGGATAATCGTAGAGAGCC -> GGCACGGATAATCGTAGAGAGCCC
CACGGAGACGGCGGCAATATCTCA -> ACGGAGACGGCGGCAATATCTCAG
CTGATATTATTACTACATGCCGGT -> TGATATTATTACTACATGCCGGTT
TAGAGCCTGATTCTAGACCAATTA -> AGAGCCTGATTCTAGACCAATTAA
TGAGTGTCGCGGTTTGTTCTCAAA -> GAGTGTCGCGGTTTGTTCTCAAAG
TACGTCCCACGACTTCTCATGGAA -> ACGTCCCACGACTTCTCATGGAAG
AAAAATGCCAAACATGCGCGAGGT -> AAAATGCCAAACATGCGCGAGGTC
TAGAGAGCCCTGTGGCCCCCAAAG -> AGAGAGCCCTGTGGCCCCCAAAGC
ATCCGTTACATGGATTTGTCATGT -> TCCGTTACATGGATTTGTCATGTG
TGTTGCCATCAATTCTGCAGGTTT -> GTTGCCATCAATTCTGCAGGTTTT
CGAGTTGTCTCTAAGCATCCCTCC -> GAGTTGTCTCTAAGCATCCCTCCA
ACTCCGAACGTAATGGAGAGGTAT -> CTCCGAACGTAATGGAGAGGTATT
TTACCTCGACCATGGACACAGATC -> TACCTCGACCATGGACACAGATCG
TCAGATCCAGGTATTTGTGTCAAA -> CAGATCCAGGTATTTGTGTCAAAT
GCATGATCGCAGGTGGGTGCAGCA -> CATGATCGCAGGTGGGTGCAGCAG
TCTCTCGCGTGGCAAATTGCTCGC -> CTCTCGCGTGGCAAATTGCTCGCT
CGATTGTACAAAGGTTGCCTCTGT -> GATTGTACAAAGGTTGCCTCTGTG
GCTCAACCGTTTGTCTTTGGTAAG -> CTCAACCGTTTGTCTTTGGTAAGT
CGGGGGGTGCATAGCAACTTTGGC -> GGGGGGTGCATAGCAACTTTGGCG
GCGGGGCCCGACACGGCTGCAAGA -> CGGGGCCCGACACGGCTGCAAGAA
TCGAGCGACTCAGATGTAAGTCTA -> CGAGCGACTCAGATGTAAGTCTAT
GGCAGGTCAAACGGTACTATGGTC -> GCAGGTCAAACGGTACTATGGTCT
AGATCCAGGTATTTGTGTCAAATC -> GATCCAGGTATTTGTGTCAAATCA
CAATAGGTGACGTGAAACCACGTC -> AATAGGTGACGTGAAACCACGTCC
GGTAGGTACCGCGGACCTCTACCG -> GTAGGTACCGCGGACCTCTACCGC
AAGTCCGACGGCTCGACCCGGTAG -> AGTCCGACGGCTCGACCCGGTAGT
GTGGGTGCAGCAGTACTACACTCT -> TGGGTGCAGCAGTACTACACTCTC
TCACACATCAAACGTTCGTGCCGC -> CACACATCAAACGTTCGTGCCGCT
GTTTCTGCAACTGACCCTCTCAGT -> TTTCTGCAACTGACCCTCTCAGTG
GTCCCACGACTTCTCATGGAAGAT -> TCCCACGACTTCTCATGGAAGATG
CGGCCCTCATTATCGGCCTGCACC -> GGCCCTCATTATCGGCCTGCACCA
TAGTGAAGACCGGACACTGCCGCC -> AGTGAAGACCGGACACTGCCGCCC
AACCACGTCCTATAGAGCCTGATT -> ACCACGTCCTATAGAGCCTGATTC
TGCACGGGTGACCGTTCTGGAATC -> GCACGGGTGACCGTTCTGGAATCG
CTTTGAATGAGGCTGATTTATAAG -> TTTGAATGAGGCTGATTTATAAGC
CGGCACGCGGTAGTACCTATCCCC -> GGCACGCGGTAGTACCTATCCCCC
ATAGGTGACGTGAAACCACGTCCT -> TAGGTGACGTGAAACCACGTCCTA
ATTCAGACTGCCCCAGATCCCGCC -> TTCAGACTGCCCCAGATCCCGCCA
CCATGGACACAGATCGATGCACGT -> CATGGACACAGATCGATGCACGTT
TTCTCAAAGGGCGGCTCAACCGTT -> TCTCAAAGGGCGGCTCAACCGTTT
CGACTTCTCATGGAAGATGCTACC -> GACTTCTCATGGAAGATGCTACCA
ATGGCAGTAGAATTGTGATCGATC -> TGGCAGTAGAATTGTGATCGATCA
CAGGTCAAACGGTACTATGGTCTC -> AGGTCAAACGGTACTATGGTCTCG
CGTAGGGAATAGTGTCAAGTCACC -> GTAGGGAATAGTGTCAAGTCACCG
ACACGCAGCCCTGACTCGAGCGCT -> CACGCAGCCCTGACTCGAGCGCTG
CGCAACGGCACACACCGAAAACAT -> GCAACGGCACACACCGAAAACATG
GAGACCCTCCCTGCCTGCCTCGAG -> AGACCCTCCCTGCCTGCCTCGAGT
CGCTGAGCAACGGACCACCCTACA -> GCTGAGCAACGGACCACCCTACAA
TTTGTTACACCCTTCCGGCTGGTC -> TTGTTACACCCTTCCGGCTGGTCA
GGGAACAGGCAGGTCAAACGGTAC -> GGAACAGGCAGGTCAAACGGTACT
CTTATTATCCCGTCTTTGAATGAG -> TTATTATCCCGTCTTTGAATGAGG
CTGACCCTCTCAGTGTTATGCTCT -> TGACCCTCTCAGTGTTATGCTCTG
AATCAGCATGATCGCAGGTGGGTG -> ATCAGCATGATCGCAGGTGGGTGC
AAACATGCGCGAGGTCAAAGGGGT -> AACATGCGCGAGGTCAAAGGGGTA
ATGAGGCTGATTTATAAGCCAGAC -> TGAGGCTGATTTATAAGCCAGACC
GGTAGTACCTATCCCCCGTAAATT -> GTAGTACCTATCCCCCGTAAATTT
GGTTGCCTCTGTGTAACGGGACCA -> GTTGCCTCTGTGTAACGGGACCAG
AAGCATCCCTCCATTACGTCCCAC -> AGCATCCCTCCATTACGTCCCACG
CCGCAGATTAAATATTGCTAAACC -> CGCAGATTAAATATTGCTAAACCC
GTTCGTGCCGCTGAGCAACGGACC -> TTCGTGCCGCTGAGCAACGGACCA
TATTTGTGTCAAATCAGCATGATC -> ATTTGTGTCAAATCAGCATGATCG
GGCACGGATAATCGTAGAGAGCCC -> GCACGGATAATCGTAGAGAGCCCT
GTAGCCTGTAACGCTGTACACCGG -> TAGCCTGTAACGCTGTACACCGGA
CGCGGTAGTACCTATCCCCCGTAA -> GCGGTAGTACCTATCCCCCGTAAA
AGGTATTTGTGTCAAATCAGCATG -> GGTATTTGTGTCAAATCAGCATGA
AGGGCACGGATAATCGTAGAGAGC -> GGGCACGGATAATCGTAGAGAGCC
CAGGACCCAATATCTACAGGGGGC -> AGGACCCAATATCTACAGGGGGCG
TTGAATAATTCCGCAGATTAAATA -> TGAATAATTCCGCAGATTAAATAT
TACCGCACAATGGCAGTAGAATTG -> ACCGCACAATGGCAGTAGAATTGT
TCTTATTCTTTCTCACACGCAGCC -> CTTATTCTTTCTCACACGCAGCCC
CAGTAGAATTGTGATCGATCACGC -> AGTAGAATTGTGATCGATCACGCC
TTTGGTATTAGGAGTGTCAAACAG -> TTGGTATTAGGAGTGTCAAACAGC
ACGGCTGCAAGAACGCCTGTTGTG -> CGGCTGCAAGAACGCCTGTTGTGC
TTTAACGTATCGCTTTGTTGAGCA -> TTAACGTATCGCTTTGTTGAGCAC
CTAAACCCAAGACGGGACGATGTT -> TAAACCCAAGACGGGACGATGTTG
CCGATTTTTTACGGCCCTCATTAT -> CGATTTTTTACGGCCCTCATTATC
GAAGACCGGACACTGCCGCCCGGC -> AAGACCGGACACTGCCGCCCGGCA
TCGTATATCGTAGGGAATAGTGTC -> CGTATATCGTAGGGAATAGTGTCA
CTCATTATCGGCCTGCACCAGTTT -> TCATTATCGGCCTGCACCAGTTTA
CAAACGATAATCTACGTCCCTCGC -> AAACGATAATCTACGTCCCTCGCG
TGGAGAGGTATTTCTTATTCTTTC -> GGAGAGGTATTTCTTATTCTTTCT
GACCATGGACACAGATCGATGCAC -> ACCATGGACACAGATCGATGCACG
AGTGTCAAGTCACCGTCTAATGTT -> GTGTCAAGTCACCGTCTAATGTTA
ATGCTACCAAGGAGCCACTTCGAA -> TGCTACCAAGGAGCCACTTCGAAT
TTTCTGCAACTGACCCTCTCAGTG -> TTCTGCAACTGACCCTCTCAGTGT
GCCTGTAACGCTGTACACCGGATC -> CCTGTAACGCTGTACACCGGATCG
GCGATGCACGGGTGACCGTTCTGG -> CGATGCACGGGTGACCGTTCTGGA
CACGCAGCCCTGACTCGAGCGCTG -> ACGCAGCCCTGACTCGAGCGCTGT
CGCTTTGTTGAGCACGGAGACGGC -> GCTTTGTTGAGCACGGAGACGGCG
ACCGTTCTGGAATCGTGGAGGTCA -> CCGTTCTGGAATCGTGGAGGTCAC
CCAATACTACAGGTCGTGGTCCCG -> CAATACTACAGGTCGTGGTCCCGC
TGCTATTCAGACTGCCCCAGATCC -> GCTATTCAGACTGCCCCAGATCCC
GAATGAGGCTGATTTATAAGCCAG -> AATGAGGCTGATTTATAAGCCAGA
TTCGAATAATGGCGATGCACGGGT -> TCGAATAATGGCGATGCACGGGTG
TCCCTCGCGCCACGAGCTACAACA -> CCCTCGCGCCACGAGCTACAACAC
TATTCTTTCTCACACGCAGCCCTG -> ATTCTTTCTCACACGCAGCCCTGA
CCGTTTCTGCAACTGACCCTCTCA -> CGTTTCTGCAACTGACCCTCTCAG
GTCTATAGCAAGGGCACGGATAAT -> TCTATAGCAAGGGCACGGATAATC
CCGCCCGGCACGCGGTAGTACCTA -> CGCCCGGCACGCGGTAGTACCTAT
GCCTCCCTTAAGTCACGGGGGGTG -> CCTCCCTTAAGTCACGGGGGGTGC
TAGTTTAACGTATCGCTTTGTTGA -> AGTTTAACGTATCGCTTTGTTGAG
ACGGGGGGTGCATAGCAACTTTGG -> CGGGGGGTGCATAGCAACTTTGGC
TGTTACCTCGACCATGGACACAGA -> GTTACCTCGACCATGGACACAGAT
CGAAGTTTTGGAGGTAAGATAACA -> GAAGTTTTGGAGGTAAGATAACAC
GACACTGCCGCCCGGCACGCGGTA -> ACACTGCCGCCCGGCACGCGGTAG
CTGGTCAGATCCAGGTATTTGTGT -> TGGTCAGATCCAGGTATTTGTGTC
TTATGGCTTTCCACGCTTAACACA -> TATGGCTTTCCACGCTTAACACAG
TTTTTACGGCCCTCATTATCGGCC -> TTTTACGGCCCTCATTATCGGCCT
TATGGCTTTCCACGCTTAACACAG -> ATGGCTTTCCACGCTTAACACAGG
CCTATCCCCCGTAAATTTGTTACA -> CTATCCCCCGTAAATTTGTTACAC
ATGCCTTCGTTAACTTATGGCTTT -> TGCCTTCGTTAACTTATGGCTTTC
AAACATGGTAAAAATGCCAAACAT -> AACATGGTAAAAATGCCAAACATG
AAGACGGGACGATGTTGCCATCAA -> AGACGGGACGATGTTGCCATCAAT
TTGCTAAACCCAAGACGGGACGAT -> TGCTAAACCCAAGACGGGACGATG
ATGCGCGAGGTCAAAGGGGTAAAA -> TGCGCGAGGTCAAAGGGGTAAAAC
GTAACGCTGTACACCGGATCGAGC -> TAACGCTGTACACCGGATCGAGCG
GGTGCATAGCAACTTTGGCGACTA -> GTGCATAGCAACTTTGGCGACTAA
CTCCGCAACGGCACACACCGAAAA -> TCCGCAACGGCACACACCGAAAAC
TACGTCCCTCGCGCCACGAGCTAC -> ACGTCCCTCGCGCCACGAGCTACA
TGTAAGTCTATAGCAAGGGCACGG -> GTAAGTCTATAGCAAGGGCACGGA
GCTCATCCAAGGTGTCAATGTTCC -> CTCATCCAAGGTGTCAATGTTCCA
CAGGCTAGAGGCAACAGTTTGGTA -> AGGCTAGAGGCAACAGTTTGGTAT
ATCTCTATAGTGAAGACCGGACAC -> TCTCTATAGTGAAGACCGGACACT
AATGTTACCTCGACCATGGACACA -> ATGTTACCTCGACCATGGACACAG
CGAACATTACCTTTGAGCAGCTCG -> GAACATTACCTTTGAGCAGCTCGG
TTTATAAGCCAGACCGAACATTAC -> TTATAAGCCAGACCGAACATTACC
AAGGTGTCAATGTTCCATCGTATA -> AGGTGTCAATGTTCCATCGTATAT
TCCCTCCATTACGTCCCACGACTT -> CCCTCCATTACGTCCCACGACTTC
TGTGGCCCCCAAAGCAAGTCATGG -> GTGGCCCCCAAAGCAAGTCATGGA
CGTTTCTGCAACTGACCCTCTCAG -> GTTTCTGCAACTGACCCTCTCAGT
ACCCTGATATTATTACTACATGCC -> CCCTGATATTATTACTACATGCCG
GTTACACCCTTCCGGCTGGTCAGA -> TTACACCCTTCCGGCTGGTCAGAT
TCTCTAAAATCCTTGCACAGTTCC -> CTCTAAAATCCTTGCACAGTTCCG
CGATGTTGCCATCAATTCTGCAGG -> GATGTTGCCATCAATTCTGCAGGT
CACGGGTGACCGTTCTGGAATCGT -> ACGGGTGACCGTTCTGGAATCGTG
CGGATAATCGTAGAGAGCCCTGTG -> GGATAATCGTAGAGAGCCCTGTGG
CCTCGACCATGGACACAGATCGAT -> CTCGACCATGGACACAGATCGATG
CGCACTTCGGACATCGAATCTGTT -> GCACTTCGGACATCGAATCTGTTA
ACAAAGGTTGCCTCTGTGTAACGG -> CAAAGGTTGCCTCTGTGTAACGGG
GATTCACACATCAAACGTTCGTGC -> ATTCACACATCAAACGTTCGTGCC
CCCAATATCTACAGGGGGCGGGGC -> CCAATATCTACAGGGGGCGGGGCC
GACCCAATATCTACAGGGGGCGGG -> ACCCAATATCTACAGGGGGCGGGG
TCACGCTCAGGTAGGTACCGCGGA -> CACGCTCAGGTAGGTACCGCGGAC
CCCAATAGGTGACGTGAAACCACG -> CCAATAGGTGACGTGAAACCACGT
GGAACGTCCTTCACTCCGCAACGG -> GAACGTCCTTCACTCCGCAACGGC
GGTAAAAATGCCAAACATGCGCGA -> GTAAAAATGCCAAACATGCGCGAG
GCAGTAGAATTGTGATCGATCACG -> CAGTAGAATTGTGATCGATCACGC
CGGCACACACCGAAAACATGGTAA -> GGCACACACCGAAAACATGGTAAA
CAAAGCAAGTCATGGAACGTCCTT -> AAAGCAAGTCATGGAACGTCCTTC
GTTGAATAATTCCGCAGATTAAAT -> TTGAATAATTCCGCAGATTAAATA
CAGATTTACGAGAGCTTAGTACGT -> AGATTTACGAGAGCTTAGTACGTC
GCAACTGACCCTCTCAGTGTTATG -> CAACTGACCCTCTCAGTGTTATGC
CTCTGTGTAACGGGACCAGCCCGC -> TCTGTGTAACGGGACCAGCCCGCT
ACACCCTGATATTATTACTACATG -> CACCCTGATATTATTACTACATGC
GACCAACCTTATTATCCCGTCTTT -> ACCAACCTTATTATCCCGTCTTTG
GGTCTCGATTGTACAAAGGTTGCC -> GTCTCGATTGTACAAAGGTTGCCT
AATGCCAAACATGCGCGAGGTCAA -> ATGCCAAACATGCGCGAGGTCAAA
ATTCCGCAGATTAAATATTGCTAA -> TTCCGCAGATTAAATATTGCTAAA
GTGTCGCGGTTTGTTCTCAAAGGG -> TGTCGCGGTTTGTTCTCAAAGGGC
TGGAGGTAAGATAACACGAATTGC -> GGAGGTAAGATAACACGAATTGCG
GAAGCCTCTGTCGGCCTTACTGTT -> AAGCCTCTGTCGGCCTTACTGTTC
CGGAGACGGCGGCAATATCTCAGG -> GGAGACGGCGGCAATATCTCAGGC
TGCCAGTTCAAACGATAATCTACG -> GCCAGTTCAAACGATAATCTACGT
ATGGCTTTCCACGCTTAACACAGG -> TGGCTTTCCACGCTTAACACAGGA
GGGGTAAAACACCCTGATATTATT -> GGGTAAAACACCCTGATATTATTA
GGCGGCTCAACCGTTTGTCTTTGG -> GCGGCTCAACCGTTTGTCTTTGGT
TGGAATCGTGGAGGTCACGCTCAG -> GGAATCGTGGAGGTCACGCTCAGG
GCCTCTGTGTAACGGGACCAGCCC -> CCTCTGTGTAACGGGACCAGCCCG
AATGGAGAGGTATTTCTTATTCTT -> ATGGAGAGGTATTTCTTATTCTTT
ATCGTAGGGAATAGTGTCAAGTCA -> TCGTAGGGAATAGTGTCAAGTCAC
CGAGGTCAAAGGGGTAAAACACCC -> GAGGTCAAAGGGGTAAAACACCCT
CCTGTAACGCTGTACACCGGATCG -> CTGTAACGCTGTACACCGGATCGA
ACTTCGAATAATGGCGATGCACGG -> CTTCGAATAATGGCGATGCACGGG
AGACCCTCCCTGCCTGCCTCGAGT -> GACCCTCCCTGCCTGCCTCGAGTT
GGTAGTCCGATGGACCAGATCTCT -> GTAGTCCGATGGACCAGATCTCTA
TAGTGTCAAGTCACCGTCTAATGT -> AGTGTCAAGTCACCGTCTAATGTT
CCTGTGGCCCCCAAAGCAAGTCAT -> CTGTGGCCCCCAAAGCAAGTCATG
CCTCATTATCGGCCTGCACCAGTT -> CTCATTATCGGCCTGCACCAGTTT
CTGCCTGCCTCGAGTTGTCTCTAA -> TGCCTGCCTCGAGTTGTCTCTAAG
CGGGACGATGTTGCCATCAATTCT -> GGGACGATGTTGCCATCAATTCTG
TCCGATGGACCAGATCTCTATAGT -> CCGATGGACCAGATCTCTATAGTG
TTGTTACACCCTTCCGGCTGGTCA -> TGTTACACCCTTCCGGCTGGTCAG
CGCCACGAGCTACAACACACCGAA -> GCCACGAGCTACAACACACCGAAG
GTACCGCGGACCTCTACCGCACAA -> TACCGCGGACCTCTACCGCACAAT
CAACGGACCACCCTACAAGAGTTA -> AACGGACCACCCTACAAGAGTTAG
CCATCGTATATCGTAGGGAATAGT -> CATCGTATATCGTAGGGAATAGTG
CAGGTGGGTGCAGCAGTACTACAC -> AGGTGGGTGCAGCAGTACTACACT
TAAGGATCCGATCCGTCCCCAATA -> AAGGATCCGATCCGTCCCCAATAG
GGTTTGTTCTCAAAGGGCGGCTCA -> GTTTGTTCTCAAAGGGCGGCTCAA
TCCCTTAAGTCACGGGGGGTGCAT -> CCCTTAAGTCACGGGGGGTGCATA
GGCTTTCCACGCTTAACACAGGAA -> GCTTTCCACGCTTAACACAGGAAG
CCACCCTACAAGAGTTAGTTTAAC -> CACCCTACAAGAGTTAGTTTAACG
GGAATCGTGGAGGTCACGCTCAGG -> GAATCGTGGAGGTCACGCTCAGGT
TAGGAGTGTCAAACAGCAGATTTA -> AGGAGTGTCAAACAGCAGATTTAC
CAGGTATTTGTGTCAAATCAGCAT -> AGGTATTTGTGTCAAATCAGCATG
TCCAGGTATTTGTGTCAAATCAGC -> CCAGGTATTTGTGTCAAATCAGCA
CAGGTAGGTACCGCGGACCTCTAC -> AGGTAGGTACCGCGGACCTCTACC
GGTATTTGTGTCAAATCAGCATGA -> GTATTTGTGTCAAATCAGCATGAT
CGTCCTATAGAGCCTGATTCTAGA -> GTCCTATAGAGCCTGATTCTAGAC
GCCAAACATGCGCGAGGTCAAAGG -> CCAAACATGCGCGAGGTCAAAGGG
GAGACGTAGCCTCCCTTAAGTCAC -> AGACGTAGCCTCCCTTAAGTCACG
ATGGCGATGCACGGGTGACCGTTC -> TGGCGATGCACGGGTGACCGTTCT
GCACACACCGAAAACATGGTAAAA -> CACACACCGAAAACATGGTAAAAA
TTCAAACGATAATCTACGTCCCTC -> TCAAACGATAATCTACGTCCCTCG
TGTAACGGGACCAGCCCGCTCTCT -> GTAACGGGACCAGCCCGCTCTCTC
ACACGGCTGCAAGAACGCCTGTTG -> CACGGCTGCAAGAACGCCTGTTGT
TGCCGGTTCGAGACCCTCCCTGCC -> GCCGGTTCGAGACCCTCCCTGCCT
GTGTAACGGGACCAGCCCGCTCTC -> TGTAACGGGACCAGCCCGCTCTCT
GGAGGTAAGATAACACGAATTGCG -> GAGGTAAGATAACACGAATTGCGC
TGAGCACGGAGACGGCGGCAATAT -> GAGCACGGAGACGGCGGCAATATC
GGATCTCTCTAAAATCCTTGCACA -> GATCTCTCTAAAATCCTTGCACAG
GCCCTCATTATCGGCCTGCACCAG -> CCCTCATTATCGGCCTGCACCAGT
TTATCCCGTCTTTGAATGAGGCTG -> TATCCCGTCTTTGAATGAGGCTGA
CGTTACATGGATTTGTCATGTGAG -> GTTACATGGATTTGTCATGTGAGG
GCCTCGAGTTGTCTCTAAGCATCC -> CCTCGAGTTGTCTCTAAGCATCCC
AGAGCCCTGTGGCCCCCAAAGCAA -> GAGCCCTGTGGCCCCCAAAGCAAG
TAGTACGTCCGCTAATCTCGACCA -> AGTACGTCCGCTAATCTCGACCAA
GCAATATCTCAGGCTAGAGGCAAC -> CAATATCTCAGGCTAGAGGCAACA
CCAAGACGGGACGATGTTGCCATC -> CAAGACGGGACGATGTTGCCATCA
AGCCCTGTGGCCCCCAAAGCAAGT -> GCCCTGTGGCCCCCAAAGCAAGTC
GCCCGACACGGCTGCAAGAACGCC -> CCCGACACGGCTGCAAGAACGCCT
CAGATTAAATATTGCTAAACCCAA -> AGATTAAATATTGCTAAACCCAAG
CACGTCCTATAGAGCCTGATTCTA -> ACGTCCTATAGAGCCTGATTCTAG
GGCCCCCAAAGCAAGTCATGGAAC -> GCCCCCAAAGCAAGTCATGGAACG
CTTTGGCGACTAAATCGGCACTAG -> TTTGGCGACTAAATCGGCACTAGT
TCAAGTCACCGTCTAATGTTACCT -> CAAGTCACCGTCTAATGTTACCTC
TTATTATCCCGTCTTTGAATGAGG -> TATTATCCCGTCTTTGAATGAGGC
TTCAGATCGAGACGTAGCCTCCCT -> TCAGATCGAGACGTAGCCTCCCTT
ATGCACGTTTCGAAACTATATGCC -> TGCACGTTTCGAAACTATATGCCT
AGTTTAACGTATCGCTTTGTTGAG -> GTTTAACGTATCGCTTTGTTGAGC
AGGATCCGATCCGTCCCCAATAGG -> GGATCCGATCCGTCCCCAATAGGT
CACGGATAATCGTAGAGAGCCCTG -> ACGGATAATCGTAGAGAGCCCTGT
CGAGACGTAGCCTCCCTTAAGTCA -> GAGACGTAGCCTCCCTTAAGTCAC
CCACGTCCTATAGAGCCTGATTCT -> CACGTCCTATAGAGCCTGATTCTA
AGGATCTCTCTAAAATCCTTGCAC -> GGATCTCTCTAAAATCCTTGCACA
GGGTGACCGTTCTGGAATCGTGGA -> GGTGACCGTTCTGGAATCGTGGAG
TATGCTTACAACTCGCACTTCGGA -> ATGCTTACAACTCGCACTTCGGAC
TAGCAGCAGAATGGGTGTCGAAGC -> AGCAGCAGAATGGGTGTCGAAGCC
TTGTGATCGATCACGCCAAGACAA -> TGTGATCGATCACGCCAAGACAAC
TCTATAGCAAGGGCACGGATAATC -> CTATAGCAAGGGCACGGATAATCG
CAAACGTTCGTGCCGCTGAGCAAC -> AAACGTTCGTGCCGCTGAGCAACG
TTAAGTCACGGGGGGTGCATAGCA -> TAAGTCACGGGGGGTGCATAGCAA
TGGTCAGATCCAGGTATTTGTGTC -> GGTCAGATCCAGGTATTTGTGTCA
TCAAAGGGCGGCTCAACCGTTTGT -> CAAAGGGCGGCTCAACCGTTTGTC
ACGCAGCCCTGACTCGAGCGCTGT -> CGCAGCCCTGACTCGAGCGCTGTC
AGTTGTCTCTAAGCATCCCTCCAT -> GTTGTCTCTAAGCATCCCTCCATT
AGTGGCCGATTTTTTACGGCCCTC -> GTGGCCGATTTTTTACGGCCCTCA
ATCCCTCCATTACGTCCCACGACT -> TCCCTCCATTACGTCCCACGACTT
TGTCGTAGCAGCAGAATGGGTGTC -> GTCGTAGCAGCAGAATGGGTGTCG
GAGTGTCGCGGTTTGTTCTCAAAG -> AGTGTCGCGGTTTGTTCTCAAAGG
CCATTACGTCCCACGACTTCTCAT -> CATTACGTCCCACGACTTCTCATG
CTGATTCTAGACCAATTAAGTCCG -> TGATTCTAGACCAATTAAGTCCGA
CCGTCTAATGTTACCTCGACCATG -> CGTCTAATGTTACCTCGACCATGG
GGCACGCGGTAGTACCTATCCCCC -> GCACGCGGTAGTACCTATCCCCCG
CCGGACACTGCCGCCCGGCACGCG -> CGGACACTGCCGCCCGGCACGCGG
GATTTACGAGAGCTTAGTACGTCC -> ATTTACGAGAGCTTAGTACGTCCG
CAAATCAGCATGATCGCAGGTGGG -> AAATCAGCATGATCGCAGGTGGGT
AGGTAAGATAACACGAATTGCGCT -> GGTAAGATAACACGAATTGCGCTT
ATGATCGCAGGTGGGTGCAGCAGT -> TGATCGCAGGTGGGTGCAGCAGTA
TAATGGCGATGCACGGGTGACCGT -> AATGGCGATGCACGGGTGACCGTT
GCAGGACCCAATATCTACAGGGGG -> CAGGACCCAATATCTACAGGGGGC
CACCAGTTTAAGGATCCGATCCGT -> ACCAGTTTAAGGATCCGATCCGTC
ACACAGGAAGTTACCCAAAATACA -> CACAGGAAGTTACCCAAAATACAT
AAACTATATGCCTTCGTTAACTTA -> AACTATATGCCTTCGTTAACTTAT
TGAGCAGCTCGGTGAGTGTCGCGG -> GAGCAGCTCGGTGAGTGTCGCGGT
ACTCCGCAACGGCACACACCGAAA -> CTCCGCAACGGCACACACCGAAAA
TAAATCGGCACTAGTGACAAGTGT -> AAATCGGCACTAGTGACAAGTGTT
GCTTAACCGTTTCTGCAACTGACC -> CTTAACCGTTTCTGCAACTGACCC
CAGATGTAAGTCTATAGCAAGGGC -> AGATGTAAGTCTATAGCAAGGGCA
AGCCTCCCTTAAGTCACGGGGGGT -> GCCTCCCTTAAGTCACGGGGGGTG
TTCTGGAATCGTGGAGGTCACGCT -> TCTGGAATCGTGGAGGTCACGCTC
GCAAATTGCTCGCTCATCCAAGGT -> CAAATTGCTCGCTCATCCAAGGTG
CCGCTGTCAACCTACCGTTGATTC -> CGCTGTCAACCTACCGTTGATTCA
GGCCCGACACGGCTGCAAGAACGC -> GCCCGACACGGCTGCAAGAACGCC
TTGAGCACGGAGACGGCGGCAATA -> TGAGCACGGAGACGGCGGCAATAT
GTCTGGCCTAACCAGGATCTCTCT -> TCTGGCCTAACCAGGATCTCTCTA
GCTACAACACACCGAAGTTTTGGA -> CTACAACACACCGAAGTTTTGGAG
TCCCGTCTTTGAATGAGGCTGATT -> CCCGTCTTTGAATGAGGCTGATTT
ATGTTACCTCGACCATGGACACAG -> TGTTACCTCGACCATGGACACAGA
TAGTGGCCGATTTTTTACGGCCCT -> AGTGGCCGATTTTTTACGGCCCTC
GAGTTAGCCGATATGCTTACAACT -> AGTTAGCCGATATGCTTACAACTC
GACCAATTAAGTCCGACGGCTCGA -> ACCAATTAAGTCCGACGGCTCGAC
AACGTCCTTCACTCCGCAACGGCA -> ACGTCCTTCACTCCGCAACGGCAC
CTCTCGCGTGGCAAATTGCTCGCT -> TCTCGCGTGGCAAATTGCTCGCTC
TCTGTGTAACGGGACCAGCCCGCT -> CTGTGTAACGGGACCAGCCCGCTC
GACGTGAAACCACGTCCTATAGAG -> ACGTGAAACCACGTCCTATAGAGC
TTGATTCACACATCAAACGTTCGT -> TGATTCACACATCAAACGTTCGTG
GCGACTCAGATGTAAGTCTATAGC -> CGACTCAGATGTAAGTCTATAGCA
CATCTCACCAATACTACAGGTCGT -> ATCTCACCAATACTACAGGTCGTG
GTTTAACGTATCGCTTTGTTGAGC -> TTTAACGTATCGCTTTGTTGAGCA
GTTCAAACGATAATCTACGTCCCT -> TTCAAACGATAATCTACGTCCCTC
CATTACGTCCCACGACTTCTCATG -> ATTACGTCCCACGACTTCTCATGG
CTGCCGCCCGGCACGCGGTAGTAC -> TGCCGCCCGGCACGCGGTAGTACC
GAGTTAGTTTAACGTATCGCTTTG -> AGTTAGTTTAACGTATCGCTTTGT
TCTCAAAGGGCGGCTCAACCGTTT -> CTCAAAGGGCGGCTCAACCGTTTG
ACTCGCACTTCGGACATCGAATCT -> CTCGCACTTCGGACATCGAATCTG
GTCAAATCAGCATGATCGCAGGTG -> TCAAATCAGCATGATCGCAGGTGG
AAGATGCTACCAAGGAGCCACTTC -> AGATGCTACCAAGGAGCCACTTCG
AACCAGGATCTCTCTAAAATCCTT -> ACCAGGATCTCTCTAAAATCCTTG
CTGTCGGCCTTACTGTTCAGATCG -> TGTCGGCCTTACTGTTCAGATCGA
GGCAACAGTTTGGTATTAGGAGTG -> GCAACAGTTTGGTATTAGGAGTGT
GCCGCTGTCAACCTACCGTTGATT -> CCGCTGTCAACCTACCGTTGATTC
ATTCTAGACCAATTAAGTCCGACG -> TTCTAGACCAATTAAGTCCGACGG
AACTTTGGCGACTAAATCGGCACT -> ACTTTGGCGACTAAATCGGCACTA
GTTACATGGATTTGTCATGTGAGG -> TTACATGGATTTGTCATGTGAGGG
TGTGAGGGAACAGGCAGGTCAAAC -> GTGAGGGAACAGGCAGGTCAAACG
TCAGATGTAAGTCTATAGCAAGGG -> CAGATGTAAGTCTATAGCAAGGGC
GTAGGTACCGCGGACCTCTACCGC -> TAGGTACCGCGGACCTCTACCGCA
TTCTTATTCTTTCTCACACGCAGC -> TCTTATTCTTTCTCACACGCAGCC
GTTCCATCGTATATCGTAGGGAAT -> TTCCATCGTATATCGTAGGGAATA
TTGTACAAAGGTTGCCTCTGTGTA -> TGTACAAAGGTTGCCTCTGTGTAA
ATGGATTTGTCATGTGAGGGAACA -> TGGATTTGTCATGTGAGGGAACAG
TATCGCTTTGTTGAGCACGGAGAC -> ATCGCTTTGTTGAGCACGGAGACG
CTTAAGTCACGGGGGGTGCATAGC -> TTAAGTCACGGGGGGTGCATAGCA
GGTGTCGAAGCCTCTGTCGGCCTT -> GTGTCGAAGCCTCTGTCGGCCTTA
GTCACGCTCAGGTAGGTACCGCGG -> TCACGCTCAGGTAGGTACCGCGGA
GTTAACTTATGGCTTTCCACGCTT -> TTAACTTATGGCTTTCCACGCTTA
ACCGAAGTTTTGGAGGTAAGATAA -> CCGAAGTTTTGGAGGTAAGATAAC
GTCGAATATCCGTTACATGGATTT -> TCGAATATCCGTTACATGGATTTG
CCCGTAAATTTGTTACACCCTTCC -> CCGTAAATTTGTTACACCCTTCCG
AGTGACAAGTGTTCATCTCACCAA -> GTGACAAGTGTTCATCTCACCAAT
GTATATCGTAGGGAATAGTGTCAA -> TATATCGTAGGGAATAGTGTCAAG
ACTTTGGCGACTAAATCGGCACTA -> CTTTGGCGACTAAATCGGCACTAG
AACGTAATGGAGAGGTATTTCTTA -> ACGTAATGGAGAGGTATTTCTTAT
CCCCAGATCCCGCCACTAGCCGCT -> CCCAGATCCCGCCACTAGCCGCTG
TGCCGCCCGGCACGCGGTAGTACC -> GCCGCCCGGCACGCGGTAGTACCT
CCGCTGAGCAACGGACCACCCTAC -> CGCTGAGCAACGGACCACCCTACA
CGGGACCAGCCCGCTCTCTCGCGT -> GGGACCAGCCCGCTCTCTCGCGTG
TATCCCGTCTTTGAATGAGGCTGA -> ATCCCGTCTTTGAATGAGGCTGAT
GTGTCAAGTCACCGTCTAATGTTA -> TGTCAAGTCACCGTCTAATGTTAC
ACAAGAGTTAGTTTAACGTATCGC -> CAAGAGTTAGTTTAACGTATCGCT
TCAGATCGAGACGTAGCCTCCCTT -> CAGATCGAGACGTAGCCTCCCTTA
TTGGCGACTAAATCGGCACTAGTG -> TGGCGACTAAATCGGCACTAGTGA
CAATGGCAGTAGAATTGTGATCGA -> AATGGCAGTAGAATTGTGATCGAT
ATCGATGCACGTTTCGAAACTATA -> TCGATGCACGTTTCGAAACTATAT
CTCGACCATGGACACAGATCGATG -> TCGACCATGGACACAGATCGATGC
GTTCATCTCACCAATACTACAGGT -> TTCATCTCACCAATACTACAGGTC
GTCAAGTCACCGTCTAATGTTACC -> TCAAGTCACCGTCTAATGTTACCT
GACTCGAGCGCTGTCGTAGCAGCA -> ACTCGAGCGCTGTCGTAGCAGCAG
GTGATCGATCACGCCAAGACAACA -> TGATCGATCACGCCAAGACAACAC
AAGACAACACGTCGAATATCCGTT -> AGACAACACGTCGAATATCCGTTA
TTCCGGCTGGTCAGATCCAGGTAT -> TCCGGCTGGTCAGATCCAGGTATT
ATCCAAGGTGTCAATGTTCCATCG -> TCCAAGGTGTCAATGTTCCATCGT
CGACCATGGACACAGATCGATGCA -> GACCATGGACACAGATCGATGCAC
GTGTCAATGTTCCATCGTATATCG -> TGTCAATGTTCCATCGTATATCGT
GTTATGCTCTGAGTTAGCCGATAT -> TTATGCTCTGAGTTAGCCGATATG
TGGGTGCAGCAGTACTACACTCTC -> GGGTGCAGCAGTACTACACTCTCG
ACCAATTAAGTCCGACGGCTCGAC -> CCAATTAAGTCCGACGGCTCGACC
ATCCCGTCTTTGAATGAGGCTGAT -> TCCCGTCTTTGAATGAGGCTGATT
TCGATTGTACAAAGGTTGCCTCTG -> CGATTGTACAAAGGTTGCCTCTGT
CATGTGAGGGAACAGGCAGGTCAA -> ATGTGAGGGAACAGGCAGGTCAAA
TACGTCCGCTAATCTCGACCAACC -> ACGTCCGCTAATCTCGACCAACCT
TGGAACATGCCAACTGAGTTAGTG -> GGAACATGCCAACTGAGTTAGTGG
GCTGTCGTAGCAGCAGAATGGGTG -> CTGTCGTAGCAGCAGAATGGGTGT
TCTGGAATCGTGGAGGTCACGCTC -> CTGGAATCGTGGAGGTCACGCTCA
AAGTTACCCAAAATACATAGCAGG -> AGTTACCCAAAATACATAGCAGGA
GGTAAGATAACACGAATTGCGCTT -> GTAAGATAACACGAATTGCGCTTA
GCCCTGTGGCCCCCAAAGCAAGTC -> CCCTGTGGCCCCCAAAGCAAGTCA
CCGGCTGGTCAGATCCAGGTATTT -> CGGCTGGTCAGATCCAGGTATTTG
CTTCCGGCTGGTCAGATCCAGGTA -> TTCCGGCTGGTCAGATCCAGGTAT
TCGTGCCGCTGAGCAACGGACCAC -> CGTGCCGCTGAGCAACGGACCACC
ACCAAGGAGCCACTTCGAATAATG -> CCAAGGAGCCACTTCGAATAATGG
CGAGCGCTGTCGTAGCAGCAGAAT -> GAGCGCTGTCGTAGCAGCAGAATG
GTACTACACTCTCGTTGAATAATT -> TACTACACTCTCGTTGAATAATTC
GGCAGTAGAATTGTGATCGATCAC -> GCAGTAGAATTGTGATCGATCACG
TATTAGGAGTGTCAAACAGCAGAT -> ATTAGGAGTGTCAAACAGCAGATT
AATGGCGATGCACGGGTGACCGTT -> ATGGCGATGCACGGGTGACCGTTC
TTCTAGACCAATTAAGTCCGACGG -> TCTAGACCAATTAAGTCCGACGGC
TCAGCATGATCGCAGGTGGGTGCA -> CAGCATGATCGCAGGTGGGTGCAG
GCTGCAAGAACGCCTGTTGTGCCA -> CTGCAAGAACGCCTGTTGTGCCAG
CCCTCTCAGTGTTATGCTCTGAGT -> CCTCTCAGTGTTATGCTCTGAGTT
AAAATCCTTGCACAGTTCCGCTGG -> AAATCCTTGCACAGTTCCGCTGGA
TTTACGAGAGCTTAGTACGTCCGC -> TTACGAGAGCTTAGTACGTCCGCT
CATCAATTCTGCAGGTTTTAATAG -> ATCAATTCTGCAGGTTTTAATAGT
ACGCCAAGACAACACGTCGAATAT -> CGCCAAGACAACACGTCGAATATC
GGACCACCCTACAAGAGTTAGTTT -> GACCACCCTACAAGAGTTAGTTTA
TGTCTTTGGTAAGTGTAGCCTGTA -> GTCTTTGGTAAGTGTAGCCTGTAA
GGACCAGCCCGCTCTCTCGCGTGG -> GACCAGCCCGCTCTCTCGCGTGGC
GCCTGATTCTAGACCAATTAAGTC -> CCTGATTCTAGACCAATTAAGTCC
CGATGCACGGGTGACCGTTCTGGA -> GATGCACGGGTGACCGTTCTGGAA
AGTGTTATGCTCTGAGTTAGCCGA -> GTGTTATGCTCTGAGTTAGCCGAT
TGACTCGAGCGCTGTCGTAGCAGC -> GACTCGAGCGCTGTCGTAGCAGCA
CGTTTGTCTTTGGTAAGTGTAGCC -> GTTTGTCTTTGGTAAGTGTAGCCT
ATTTATAAGCCAGACCGAACATTA -> TTTATAAGCCAGACCGAACATTAC
GAGAGCTTAGTACGTCCGCTAATC -> AGAGCTTAGTACGTCCGCTAATCT
GTTCAGATCGAGACGTAGCCTCCC -> TTCAGATCGAGACGTAGCCTCCCT
AGATCCCGCCACTAGCCGCTGTCA -> GATCCCGCCACTAGCCGCTGTCAA
CAACCGTTTGTCTTTGGTAAGTGT -> AACCGTTTGTCTTTGGTAAGTGTA
GAGCACGGAGACGGCGGCAATATC -> AGCACGGAGACGGCGGCAATATCT
GATATGCTTACAACTCGCACTTCG -> ATATGCTTACAACTCGCACTTCGG
GCAGCTCGGTGAGTGTCGCGGTTT -> CAGCTCGGTGAGTGTCGCGGTTTG
AGTTCCGCTGGAACATGCCAACTG -> GTTCCGCTGGAACATGCCAACTGA
TAGCAAGGGCACGGATAATCGTAG -> AGCAAGGGCACGGATAATCGTAGA
TTCGAAACTATATGCCTTCGTTAA -> TCGAAACTATATGCCTTCGTTAAC
ATCTACGTCCCTCGCGCCACGAGC -> TCTACGTCCCTCGCGCCACGAGCT
CTACAACACACCGAAGTTTTGGAG -> TACAACACACCGAAGTTTTGGAGG
CGTTTCGAAACTATATGCCTTCGT -> GTTTCGAAACTATATGCCTTCGTT
GCACGCGGTAGTACCTATCCCCCG -> CACGCGGTAGTACCTATCCCCCGT
TGCTCGCTCATCCAAGGTGTCAAT -> GCTCGCTCATCCAAGGTGTCAATG
GCACGGATAATCGTAGAGAGCCCT -> CACGGATAATCGTAGAGAGCCCTG
TTTGTCATGTGAGGGAACAGGCAG -> TTGTCATGTGAGGGAACAGGCAGG
CTATAGCAAGGGCACGGATAATCG -> TATAGCAAGGGCACGGATAATCGT
AGCAGCTCGGTGAGTGTCGCGGTT -> GCAGCTCGGTGAGTGTCGCGGTTT
CATGATCGCAGGTGGGTGCAGCAG -> ATGATCGCAGGTGGGTGCAGCAGT
CCGCAACGGCACACACCGAAAACA -> CGCAACGGCACACACCGAAAACAT
TGCGCTTAACCGTTTCTGCAACTG -> GCGCTTAACCGTTTCTGCAACTGA
CCACGCTTAACACAGGAAGTTACC -> CACGCTTAACACAGGAAGTTACCC
ATCTCGACCAACCTTATTATCCCG -> TCTCGACCAACCTTATTATCCCGT
GTAGGGAATAGTGTCAAGTCACCG -> TAGGGAATAGTGTCAAGTCACCGT
GGTTCGAGACCCTCCCTGCCTGCC -> GTTCGAGACCCTCCCTGCCTGCCT
CGCGCCACGAGCTACAACACACCG -> GCGCCACGAGCTACAACACACCGA
GACACGGCTGCAAGAACGCCTGTT -> ACACGGCTGCAAGAACGCCTGTTG
ATGGGTGTCGAAGCCTCTGTCGGC -> TGGGTGTCGAAGCCTCTGTCGGCC
GTGATACTCCGAACGTAATGGAGA -> TGATACTCCGAACGTAATGGAGAG
CATCCCTCCATTACGTCCCACGAC -> ATCCCTCCATTACGTCCCACGACT
CTCGACCCGGTAGTCCGATGGACC -> TCGACCCGGTAGTCCGATGGACCA
CCGGTTCGAGACCCTCCCTGCCTG -> CGGTTCGAGACCCTCCCTGCCTGC
GTCTTTGAATGAGGCTGATTTATA -> TCTTTGAATGAGGCTGATTTATAA
ATAATGGCGATGCACGGGTGACCG -> TAATGGCGATGCACGGGTGACCGT
TTCGAGACCCTCCCTGCCTGCCTC -> TCGAGACCCTCCCTGCCTGCCTCG
GACCGTTCTGGAATCGTGGAGGTC -> ACCGTTCTGGAATCGTGGAGGTCA
TCGACCATGGACACAGATCGATGC -> CGACCATGGACACAGATCGATGCA
CGAAAACATGGTAAAAATGCCAAA -> GAAAACATGGTAAAAATGCCAAAC
GATTTGTCATGTGAGGGAACAGGC -> ATTTGTCATGTGAGGGAACAGGCA
AGTTAGTTTAACGTATCGCTTTGT -> GTTAGTTTAACGTATCGCTTTGTT
CCCACGACTTCTCATGGAAGATGC -> CCACGACTTCTCATGGAAGATGCT
TACCAAGGAGCCACTTCGAATAAT -> ACCAAGGAGCCACTTCGAATAATG
ATAGCAGGACCCAATATCTACAGG -> TAGCAGGACCCAATATCTACAGGG
CATGGAACGTCCTTCACTCCGCAA -> ATGGAACGTCCTTCACTCCGCAAC
TACGAGAGCTTAGTACGTCCGCTA -> ACGAGAGCTTAGTACGTCCGCTAA
CAACTGAGTTAGTGGCCGATTTTT -> AACTGAGTTAGTGGCCGATTTTTT
ACTGAGTTAGTGGCCGATTTTTTA -> CTGAGTTAGTGGCCGATTTTTTAC
AGTAGAATTGTGATCGATCACGCC -> GTAGAATTGTGATCGATCACGCCA
ATGTGAGGGAACAGGCAGGTCAAA -> TGTGAGGGAACAGGCAGGTCAAAC
TTTACGGCCCTCATTATCGGCCTG -> TTACGGCCCTCATTATCGGCCTGC
GGTACTATGGTCTCGATTGTACAA -> GTACTATGGTCTCGATTGTACAAA
ACCTATCCCCCGTAAATTTGTTAC -> CCTATCCCCCGTAAATTTGTTACA
ACATAGCAGGACCCAATATCTACA -> CATAGCAGGACCCAATATCTACAG
AGAGGTATTTCTTATTCTTTCTCA -> GAGGTATTTCTTATTCTTTCTCAC
TATGTCTGGCCTAACCAGGATCTC -> ATGTCTGGCCTAACCAGGATCTCT
TTTAAGGATCCGATCCGTCCCCAA -> TTAAGGATCCGATCCGTCCCCAAT
CAAGACAACACGTCGAATATCCGT -> AAGACAACACGTCGAATATCCGTT
GTCGGCCTTACTGTTCAGATCGAG -> TCGGCCTTACTGTTCAGATCGAGA
ATCGCAGGTGGGTGCAGCAGTACT -> TCGCAGGTGGGTGCAGCAGTACTA
CATGGAAGATGCTACCAAGGAGCC -> ATGGAAGATGCTACCAAGGAGCCA
CTCGCACTTCGGACATCGAATCTG -> TCGCACTTCGGACATCGAATCTGT
GGCCGATTTTTTACGGCCCTCATT -> GCCGATTTTTTACGGCCCTCATTA
CAATGTTCCATCGTATATCGTAGG -> AATGTTCCATCGTATATCGTAGGG
CGTTGATTCACACATCAAACGTTC -> GTTGATTCACACATCAAACGTTCG
ACCAATACTACAGGTCGTGGTCCC -> CCAATACTACAGGTCGTGGTCCCG
GTGGAGGTCACGCTCAGGTAGGTA -> TGGAGGTCACGCTCAGGTAGGTAC
GTTCGAGACCCTCCCTGCCTGCCT -> TTCGAGACCCTCCCTGCCTGCCTC
CTCATCCAAGGTGTCAATGTTCCA -> TCATCCAAGGTGTCAATGTTCCAT
GCGCGAGGTCAAAGGGGTAAAACA -> CGCGAGGTCAAAGGGGTAAAACAC
GCCACTTCGAATAATGGCGATGCA -> CCACTTCGAATAATGGCGATGCAC
TTTGTCTTTGGTAAGTGTAGCCTG -> TTGTCTTTGGTAAGTGTAGCCTGT
GATGTTGCCATCAATTCTGCAGGT -> ATGTTGCCATCAATTCTGCAGGTT
AGGTATTTCTTATTCTTTCTCACA -> GGTATTTCTTATTCTTTCTCACAC
GGGACGATGTTGCCATCAATTCTG -> GGACGATGTTGCCATCAATTCTGC
AGGGGTAAAACACCCTGATATTAT -> GGGGTAAAACACCCTGATATTATT
GCCTGTTGTGCCAGTTCAAACGAT -> CCTGTTGTGCCAGTTCAAACGATA
AAAATGCCAAACATGCGCGAGGTC -> AAATGCCAAACATGCGCGAGGTCA
CTCCGAACGTAATGGAGAGGTATT -> TCCGAACGTAATGGAGAGGTATTT
ATTCTTTCTCACACGCAGCCCTGA -> TTCTTTCTCACACGCAGCCCTGAC
CTTTGGTAAGTGTAGCCTGTAACG -> TTTGGTAAGTGTAGCCTGTAACGC
TCTCATGGAAGATGCTACCAAGGA -> CTCATGGAAGATGCTACCAAGGAG
TCCTTCACTCCGCAACGGCACACA -> CCTTCACTCCGCAACGGCACACAC
CTCAGGCTAGAGGCAACAGTTTGG -> TCAGGCTAGAGGCAACAGTTTGGT
TGGAGGTCACGCTCAGGTAGGTAC -> GGAGGTCACGCTCAGGTAGGTACC
TCGCTTTGTTGAGCACGGAGACGG -> CGCTTTGTTGAGCACGGAGACGGC
GCCTCTGTCGGCCTTACTGTTCAG -> CCTCTGTCGGCCTTACTGTTCAGA
AGCAGAATGGGTGTCGAAGCCTCT -> GCAGAATGGGTGTCGAAGCCTCTG
GTGAGGGAACAGGCAGGTCAAACG -> TGAGGGAACAGGCAGGTCAAACGG
GAATAATGGCGATGCACGGGTGAC -> AATAATGGCGATGCACGGGTGACC
CTCTATAGTGAAGACCGGACACTG -> TCTATAGTGAAGACCGGACACTGC
GAATAATTCCGCAGATTAAATATT -> AATAATTCCGCAGATTAAATATTG
GTCACCGTCTAATGTTACCTCGAC -> TCACCGTCTAATGTTACCTCGACC
TGATCGCAGGTGGGTGCAGCAGTA -> GATCGCAGGTGGGTGCAGCAGTAC
AAGGGGTAAAACACCCTGATATTA -> AGGGGTAAAACACCCTGATATTAT
ATCCCGCCACTAGCCGCTGTCAAC -> TCCCGCCACTAGCCGCTGTCAACC
CAAGTCACCGTCTAATGTTACCTC -> AAGTCACCGTCTAATGTTACCTCG
AAACAGCAGATTTACGAGAGCTTA -> AACAGCAGATTTACGAGAGCTTAG
CTTCTCATGGAAGATGCTACCAAG -> TTCTCATGGAAGATGCTACCAAGG
CCGACGGCTCGACCCGGTAGTCCG -> CGACGGCTCGACCCGGTAGTCCGA
GCAACGGACCACCCTACAAGAGTT -> CAACGGACCACCCTACAAGAGTTA
AACCTACCGTTGATTCACACATCA -> ACCTACCGTTGATTCACACATCAA
ATGGACCAGATCTCTATAGTGAAG -> TGGACCAGATCTCTATAGTGAAGA
CAAACATGCGCGAGGTCAAAGGGG -> AAACATGCGCGAGGTCAAAGGGGT
CGCGGTTTGTTCTCAAAGGGCGGC -> GCGGTTTGTTCTCAAAGGGCGGCT
CGAGACCCTCCCTGCCTGCCTCGA -> GAGACCCTCCCTGCCTGCCTCGAG
AACCGTTTCTGCAACTGACCCTCT -> ACCGTTTCTGCAACTGACCCTCTC
GTAAATTTGTTACACCCTTCCGGC -> TAAATTTGTTACACCCTTCCGGCT
TTATTACTACATGCCGGTTCGAGA -> TATTACTACATGCCGGTTCGAGAC
CAGATCGAGACGTAGCCTCCCTTA -> AGATCGAGACGTAGCCTCCCTTAA
GAACATGCCAACTGAGTTAGTGGC -> AACATGCCAACTGAGTTAGTGGCC
ATGCCAAACATGCGCGAGGTCAAA -> TGCCAAACATGCGCGAGGTCAAAG
CTCAAAGGGCGGCTCAACCGTTTG -> TCAAAGGGCGGCTCAACCGTTTGT
TCGCACTTCGGACATCGAATCTGT -> CGCACTTCGGACATCGAATCTGTT
TTGCCATCAATTCTGCAGGTTTTA -> TGCCATCAATTCTGCAGGTTTTAA
TGCAGCAGTACTACACTCTCGTTG -> GCAGCAGTACTACACTCTCGTTGA
GCGCCACGAGCTACAACACACCGA -> CGCCACGAGCTACAACACACCGAA
AGGGAACAGGCAGGTCAAACGGTA -> GGGAACAGGCAGGTCAAACGGTAC
TGATACTCCGAACGTAATGGAGAG -> GATACTCCGAACGTAATGGAGAGG
TTAAGGATCCGATCCGTCCCCAAT -> TAAGGATCCGATCCGTCCCCAATA
CTACAGGGGGCGGGGCCCGACACG -> TACAGGGGGCGGGGCCCGACACGG
CGCAGGTGGGTGCAGCAGTACTAC -> GCAGGTGGGTGCAGCAGTACTACA
TCTCGCGTGGCAAATTGCTCGCTC -> CTCGCGTGGCAAATTGCTCGCTCA
ATATTATTACTACATGCCGGTTCG -> TATTATTACTACATGCCGGTTCGA
TACATGGATTTGTCATGTGAGGGA -> ACATGGATTTGTCATGTGAGGGAA
TAGTGATACTCCGAACGTAATGGA -> AGTGATACTCCGAACGTAATGGAG
TAAGTCTATAGCAAGGGCACGGAT -> AAGTCTATAGCAAGGGCACGGATA
GATCGAGACGTAGCCTCCCTTAAG -> ATCGAGACGTAGCCTCCCTTAAGT
TATCTCAGGCTAGAGGCAACAGTT -> ATCTCAGGCTAGAGGCAACAGTTT
TGAGTTAGCCGATATGCTTACAAC -> GAGTTAGCCGATATGCTTACAACT
CGTCCCACGACTTCTCATGGAAGA -> GTCCCACGACTTCTCATGGAAGAT
GAGGTATTTCTTATTCTTTCTCAC -> AGGTATTTCTTATTCTTTCTCACA
CCGAAGTTTTGGAGGTAAGATAAC -> CGAAGTTTTGGAGGTAAGATAACA
AATTGTGATCGATCACGCCAAGAC -> ATTGTGATCGATCACGCCAAGACA
TACCGTTGATTCACACATCAAACG -> ACCGTTGATTCACACATCAAACGT
CTCGCTCATCCAAGGTGTCAATGT -> TCGCTCATCCAAGGTGTCAATGTT
AAACGTTCGTGCCGCTGAGCAACG -> AACGTTCGTGCCGCTGAGCAACGG
TAAACCCAAGACGGGACGATGTTG -> AAACCCAAGACGGGACGATGTTGC
CGACACGGCTGCAAGAACGCCTGT -> GACACGGCTGCAAGAACGCCTGTT
CCCAAAATACATAGCAGGACCCAA -> CCAAAATACATAGCAGGACCCAAT
TGATTCTAGACCAATTAAGTCCGA -> GATTCTAGACCAATTAAGTCCGAC
CTCACACGCAGCCCTGACTCGAGC -> TCACACGCAGCCCTGACTCGAGCG
TGTCAAACAGCAGATTTACGAGAG -> GTCAAACAGCAGATTTACGAGAGC
TTACACCCTTCCGGCTGGTCAGAT -> TACACCCTTCCGGCTGGTCAGATC
AACACACCGAAGTTTTGGAGGTAA -> ACACACCGAAGTTTTGGAGGTAAG
GGCCCTCATTATCGGCCTGCACCA -> GCCCTCATTATCGGCCTGCACCAG
AAGTCACCGTCTAATGTTACCTCG -> AGTCACCGTCTAATGTTACCTCGA
CACCGAAGTTTTGGAGGTAAGATA -> ACCGAAGTTTTGGAGGTAAGATAA
TACAGGGGGCGGGGCCCGACACGG -> ACAGGGGGCGGGGCCCGACACGGC
GAGGGAACAGGCAGGTCAAACGGT -> AGGGAACAGGCAGGTCAAACGGTA
CCTCGAGTTGTCTCTAAGCATCCC -> CTCGAGTTGTCTCTAAGCATCCCT
ACACACCGAAAACATGGTAAAAAT -> CACACCGAAAACATGGTAAAAATG
GAAGTTACCCAAAATACATAGCAG -> AAGTTACCCAAAATACATAGCAGG
TCATGGAAGATGCTACCAAGGAGC -> CATGGAAGATGCTACCAAGGAGCC
TAGTCCGATGGACCAGATCTCTAT -> AGTCCGATGGACCAGATCTCTATA
CACGACTTCTCATGGAAGATGCTA -> ACGACTTCTCATGGAAGATGCTAC
CCAAGACAACACGTCGAATATCCG -> CAAGACAACACGTCGAATATCCGT
CTCAGATGTAAGTCTATAGCAAGG -> TCAGATGTAAGTCTATAGCAAGGG
TCTGTTATGTCTGGCCTAACCAGG -> CTGTTATGTCTGGCCTAACCAGGA
GCACCAGTTTAAGGATCCGATCCG -> CACCAGTTTAAGGATCCGATCCGT
ACTATGGTCTCGATTGTACAAAGG -> CTATGGTCTCGATTGTACAAAGGT
ATTTGTGTCAAATCAGCATGATCG -> TTTGTGTCAAATCAGCATGATCGC
CCCGGCACGCGGTAGTACCTATCC -> CCGGCACGCGGTAGTACCTATCCC
TCTTTGAATGAGGCTGATTTATAA -> CTTTGAATGAGGCTGATTTATAAG
GAGAGGTATTTCTTATTCTTTCTC -> AGAGGTATTTCTTATTCTTTCTCA
ATTATCCCGTCTTTGAATGAGGCT -> TTATCCCGTCTTTGAATGAGGCTG
CAAGGGCACGGATAATCGTAGAGA -> AAGGGCACGGATAATCGTAGAGAG
TGCACGTTTCGAAACTATATGCCT -> GCACGTTTCGAAACTATATGCCTT
GCTAAACCCAAGACGGGACGATGT -> CTAAACCCAAGACGGGACGATGTT
CTCTACCGCACAATGGCAGTAGAA -> TCTACCGCACAATGGCAGTAGAAT
GGCTGATTTATAAGCCAGACCGAA -> GCTGATTTATAAGCCAGACCGAAC
TAAAACACCCTGATATTATTACTA -> AAAACACCCTGATATTATTACTAC
AACAGCAGATTTACGAGAGCTTAG -> ACAGCAGATTTACGAGAGCTTAGT
GTAAGTCTATAGCAAGGGCACGGA -> TAAGTCTATAGCAAGGGCACGGAT
GTACAAAGGTTGCCTCTGTGTAAC -> TACAAAGGTTGCCTCTGTGTAACG
CTGTTATGTCTGGCCTAACCAGGA -> TGTTATGTCTGGCCTAACCAGGAT
AGTTAGTGGCCGATTTTTTACGGC -> GTTAGTGGCCGATTTTTTACGGCC
TATAGTGAAGACCGGACACTGCCG -> ATAGTGAAGACCGGACACTGCCGC
ATTTGTCATGTGAGGGAACAGGCA -> TTTGTCATGTGAGGGAACAGGCAG
GATGCACGGGTGACCGTTCTGGAA -> ATGCACGGGTGACCGTTCTGGAAT
TCTCACCAATACTACAGGTCGTGG -> CTCACCAATACTACAGGTCGTGGT
GGGTGTCGAAGCCTCTGTCGGCCT -> GGTGTCGAAGCCTCTGTCGGCCTT
TGGACCAGATCTCTATAGTGAAGA -> GGACCAGATCTCTATAGTGAAGAC
CGGTAGTACCTATCCCCCGTAAAT -> GGTAGTACCTATCCCCCGTAAATT
ATACTACAGGTCGTGGTCCCGCTT -> TACTACAGGTCGTGGTCCCGCTTG
GTCTCGATTGTACAAAGGTTGCCT -> TCTCGATTGTACAAAGGTTGCCTC
GGCCTGCACCAGTTTAAGGATCCG -> GCCTGCACCAGTTTAAGGATCCGA
TTAGTACGTCCGCTAATCTCGACC -> TAGTACGTCCGCTAATCTCGACCA
GCCAGTTCAAACGATAATCTACGT -> CCAGTTCAAACGATAATCTACGTC
ACTTCGGACATCGAATCTGTTATG -> CTTCGGACATCGAATCTGTTATGT
TAGCCGATATGCTTACAACTCGCA -> AGCCGATATGCTTACAACTCGCAC
AGTGAAGACCGGACACTGCCGCCC -> GTGAAGACCGGACACTGCCGCCCG
TTAAATATTGCTAAACCCAAGACG -> TAAATATTGCTAAACCCAAGACGG
GGAACAGGCAGGTCAAACGGTACT -> GAACAGGCAGGTCAAACGGTACTA
CGCGTGGCAAATTGCTCGCTCATC -> GCGTGGCAAATTGCTCGCTCATCC
AGGTTTTAATAGTGATACTCCGAA -> GGTTTTAATAGTGATACTCCGAAC
CGAATTGCGCTTAACCGTTTCTGC -> GAATTGCGCTTAACCGTTTCTGCA
GACAAGTGTTCATCTCACCAATAC -> ACAAGTGTTCATCTCACCAATACT
CCTGATATTATTACTACATGCCGG -> CTGATATTATTACTACATGCCGGT
CTACGTCCCTCGCGCCACGAGCTA -> TACGTCCCTCGCGCCACGAGCTAC
CCCTACAAGAGTTAGTTTAACGTA -> CCTACAAGAGTTAGTTTAACGTAT
GGACCAGATCTCTATAGTGAAGAC -> GACCAGATCTCTATAGTGAAGACC
GTGCCAGTTCAAACGATAATCTAC -> TGCCAGTTCAAACGATAATCTACG
CAAGTCATGGAACGTCCTTCACTC -> AAGTCATGGAACGTCCTTCACTCC
ACCACGTCCTATAGAGCCTGATTC -> CCACGTCCTATAGAGCCTGATTCT
TGGCTTTCCACGCTTAACACAGGA -> GGCTTTCCACGCTTAACACAGGAA
AACATTACCTTTGAGCAGCTCGGT -> ACATTACCTTTGAGCAGCTCGGTG
TGTTCAGATCGAGACGTAGCCTCC -> GTTCAGATCGAGACGTAGCCTCCC
CCGCTAATCTCGACCAACCTTATT -> CGCTAATCTCGACCAACCTTATTA
GAATCGTGGAGGTCACGCTCAGGT -> AATCGTGGAGGTCACGCTCAGGTA
ACATGGATTTGTCATGTGAGGGAA -> CATGGATTTGTCATGTGAGGGAAC
AAATTTGTTACACCCTTCCGGCTG -> AATTTGTTACACCCTTCCGGCTGG
GTTTGGTATTAGGAGTGTCAAACA -> TTTGGTATTAGGAGTGTCAAACAG
CGGGTGACCGTTCTGGAATCGTGG -> GGGTGACCGTTCTGGAATCGTGGA
TGGGTGTCGAAGCCTCTGTCGGCC -> GGGTGTCGAAGCCTCTGTCGGCCT
CGGCAATATCTCAGGCTAGAGGCA -> GGCAATATCTCAGGCTAGAGGCAA
CCTCTACCGCACAATGGCAGTAGA -> CTCTACCGCACAATGGCAGTAGAA
AGGTGGGTGCAGCAGTACTACACT -> GGTGGGTGCAGCAGTACTACACTC
AGTACCTATCCCCCGTAAATTTGT -> GTACCTATCCCCCGTAAATTTGTT
TTGTGTCAAATCAGCATGATCGCA -> TGTGTCAAATCAGCATGATCGCAG
CAACACGTCGAATATCCGTTACAT -> AACACGTCGAATATCCGTTACATG
ACGCTGTACACCGGATCGAGCGAC -> CGCTGTACACCGGATCGAGCGACT
GCCGATATGCTTACAACTCGCACT -> CCGATATGCTTACAACTCGCACTT
TTACATGGATTTGTCATGTGAGGG -> TACATGGATTTGTCATGTGAGGGA
TCTAAAATCCTTGCACAGTTCCGC -> CTAAAATCCTTGCACAGTTCCGCT
GCGCTTAACCGTTTCTGCAACTGA -> CGCTTAACCGTTTCTGCAACTGAC
CCGTAAATTTGTTACACCCTTCCG -> CGTAAATTTGTTACACCCTTCCGG
CACGTTTCGAAACTATATGCCTTC -> ACGTTTCGAAACTATATGCCTTCG
GGGTAAAACACCCTGATATTATTA -> GGTAAAACACCCTGATATTATTAC
GCGACTAAATCGGCACTAGTGACA -> CGACTAAATCGGCACTAGTGACAA
AATAGTGATACTCCGAACGTAATG -> ATAGTGATACTCCGAACGTAATGG
ACGATAATCTACGTCCCTCGCGCC -> CGATAATCTACGTCCCTCGCGCCA
GTACTATGGTCTCGATTGTACAAA -> TACTATGGTCTCGATTGTACAAAG
CCGCTCTCTCGCGTGGCAAATTGC -> CGCTCTCTCGCGTGGCAAATTGCT
ATGCACGGGTGACCGTTCTGGAAT -> TGCACGGGTGACCGTTCTGGAATC
CGCTGTACACCGGATCGAGCGACT -> GCTGTACACCGGATCGAGCGACTC
TGTCAAGTCACCGTCTAATGTTAC -> GTCAAGTCACCGTCTAATGTTACC
TAGCCTGTAACGCTGTACACCGGA -> AGCCTGTAACGCTGTACACCGGAT
AATAATGGCGATGCACGGGTGACC -> ATAATGGCGATGCACGGGTGACCG
GAGACGGCGGCAATATCTCAGGCT -> AGACGGCGGCAATATCTCAGGCTA
TCGCGCCACGAGCTACAACACACC -> CGCGCCACGAGCTACAACACACCG
CCTGCACCAGTTTAAGGATCCGAT -> CTGCACCAGTTTAAGGATCCGATC
CGGTGAGTGTCGCGGTTTGTTCTC -> GGTGAGTGTCGCGGTTTGTTCTCA
GATAATCGTAGAGAGCCCTGTGGC -> ATAATCGTAGAGAGCCCTGTGGCC
GTCAAACAGCAGATTTACGAGAGC -> TCAAACAGCAGATTTACGAGAGCT
GTGACAAGTGTTCATCTCACCAAT -> TGACAAGTGTTCATCTCACCAATA
GCAGTACTACACTCTCGTTGAATA -> CAGTACTACACTCTCGTTGAATAA
ATACTCCGAACGTAATGGAGAGGT -> TACTCCGAACGTAATGGAGAGGTA
TCCGTCCCCAATAGGTGACGTGAA -> CCGTCCCCAATAGGTGACGTGAAA
CCAACCTTATTATCCCGTCTTTGA -> CAACCTTATTATCCCGTCTTTGAA
TCTGGCCTAACCAGGATCTCTCTA -> CTGGCCTAACCAGGATCTCTCTAA
ATTGTACAAAGGTTGCCTCTGTGT -> TTGTACAAAGGTTGCCTCTGTGTA
GAGAGCCCTGTGGCCCCCAAAGCA -> AGAGCCCTGTGGCCCCCAAAGCAA
CAACTGACCCTCTCAGTGTTATGC -> AACTGACCCTCTCAGTGTTATGCT
AAGACCGGACACTGCCGCCCGGCA -> AGACCGGACACTGCCGCCCGGCAC
GACCCTCTCAGTGTTATGCTCTGA -> ACCCTCTCAGTGTTATGCTCTGAG
TCGAATATCCGTTACATGGATTTG -> CGAATATCCGTTACATGGATTTGT
ACGGCACACACCGAAAACATGGTA -> CGGCACACACCGAAAACATGGTAA
GCAGCAGTACTACACTCTCGTTGA -> CAGCAGTACTACACTCTCGTTGAA
CTTATTCTTTCTCACACGCAGCCC -> TTATTCTTTCTCACACGCAGCCCT
GCTTACAACTCGCACTTCGGACAT -> CTTACAACTCGCACTTCGGACATC
AGCAACGGACCACCCTACAAGAGT -> GCAACGGACCACCCTACAAGAGTT
TACTGTTCAGATCGAGACGTAGCC -> ACTGTTCAGATCGAGACGTAGCCT
CCACTAGCCGCTGTCAACCTACCG -> CACTAGCCGCTGTCAACCTACCGT
ATCTCACCAATACTACAGGTCGTG -> TCTCACCAATACTACAGGTCGTGG
TCCCTGCCTGCCTCGAGTTGTCTC -> CCCTGCCTGCCTCGAGTTGTCTCT
GTTTGTTCTCAAAGGGCGGCTCAA -> TTTGTTCTCAAAGGGCGGCTCAAC
GCACTTCGGACATCGAATCTGTTA -> CACTTCGGACATCGAATCTGTTAT
ATTACTACATGCCGGTTCGAGACC -> TTACTACATGCCGGTTCGAGACCC
TCTCGACCAACCTTATTATCCCGT -> CTCGACCAACCTTATTATCCCGTC
GTTTTAATAGTGATACTCCGAACG -> TTTTAATAGTGATACTCCGAACGT
GCAGGTTTTAATAGTGATACTCCG -> CAGGTTTTAATAGTGATACTCCGA
AGTTAGCCGATATGCTTACAACTC -> GTTAGCCGATATGCTTACAACTCG
CCGTCCCCAATAGGTGACGTGAAA -> CGTCCCCAATAGGTGACGTGAAAC
ACACACCGAAGTTTTGGAGGTAAG -> CACACCGAAGTTTTGGAGGTAAGA
CTACATGCCGGTTCGAGACCCTCC -> TACATGCCGGTTCGAGACCCTCCC
GGTTTTAATAGTGATACTCCGAAC -> GTTTTAATAGTGATACTCCGAACG
TGTCTGGCCTAACCAGGATCTCTC -> GTCTGGCCTAACCAGGATCTCTCT
TCTGCAACTGACCCTCTCAGTGTT -> CTGCAACTGACCCTCTCAGTGTTA
ACACGAATTGCGCTTAACCGTTTC -> CACGAATTGCGCTTAACCGTTTCT
CCAGGTATTTGTGTCAAATCAGCA -> CAGGTATTTGTGTCAAATCAGCAT
TCATCTCACCAATACTACAGGTCG -> CATCTCACCAATACTACAGGTCGT
TTAACCGTTTCTGCAACTGACCCT -> TAACCGTTTCTGCAACTGACCCTC
AACTGACCCTCTCAGTGTTATGCT -> ACTGACCCTCTCAGTGTTATGCTC
CCAAAATACATAGCAGGACCCAAT -> CAAAATACATAGCAGGACCCAATA
AGGTACCGCGGACCTCTACCGCAC -> GGTACCGCGGACCTCTACCGCACA
TCATGTGAGGGAACAGGCAGGTCA -> CATGTGAGGGAACAGGCAGGTCAA
TGTTCTCAAAGGGCGGCTCAACCG -> GTTCTCAAAGGGCGGCTCAACCGT
CCTTCCGGCTGGTCAGATCCAGGT -> CTTCCGGCTGGTCAGATCCAGGTA
TATAAGCCAGACCGAACATTACCT -> ATAAGCCAGACCGAACATTACCTT
GGGGCCCGACACGGCTGCAAGAAC -> GGGCCCGACACGGCTGCAAGAACG
CAGTACTACACTCTCGTTGAATAA -> AGTACTACACTCTCGTTGAATAAT
AACACGTCGAATATCCGTTACATG -> ACACGTCGAATATCCGTTACATGG
ACAATGGCAGTAGAATTGTGATCG -> CAATGGCAGTAGAATTGTGATCGA
CACGCTTAACACAGGAAGTTACCC -> ACGCTTAACACAGGAAGTTACCCA
CGGTTTGTTCTCAAAGGGCGGCTC -> GGTTTGTTCTCAAAGGGCGGCTCA
TTTGTGTCAAATCAGCATGATCGC -> TTGTGTCAAATCAGCATGATCGCA
TCATGGAACGTCCTTCACTCCGCA -> CATGGAACGTCCTTCACTCCGCAA
TGCTTACAACTCGCACTTCGGACA -> GCTTACAACTCGCACTTCGGACAT
CGAGCGACTCAGATGTAAGTCTAT -> GAGCGACTCAGATGTAAGTCTATA
AAACACCCTGATATTATTACTACA -> AACACCCTGATATTATTACTACAT
ACCCGGTAGTCCGATGGACCAGAT -> CCCGGTAGTCCGATGGACCAGATC
CGGCGGCAATATCTCAGGCTAGAG -> GGCGGCAATATCTCAGGCTAGAGG
TTGCCTCTGTGTAACGGGACCAGC -> TGCCTCTGTGTAACGGGACCAGCC
TTGTCTCTAAGCATCCCTCCATTA -> TGTCTCTAAGCATCCCTCCATTAC
ATAAGCCAGACCGAACATTACCTT -> TAAGCCAGACCGAACATTACCTTT
CCAGCCCGCTCTCTCGCGTGGCAA -> CAGCCCGCTCTCTCGCGTGGCAAA
TGCAACTGACCCTCTCAGTGTTAT -> GCAACTGACCCTCTCAGTGTTATG
GTGTAGCCTGTAACGCTGTACACC -> TGTAGCCTGTAACGCTGTACACCG
CGGACATCGAATCTGTTATGTCTG -> GGACATCGAATCTGTTATGTCTGG
GTGGCCCCCAAAGCAAGTCATGGA -> TGGCCCCCAAAGCAAGTCATGGAA
TATATGCCTTCGTTAACTTATGGC -> ATATGCCTTCGTTAACTTATGGCT
CAAACGGTACTATGGTCTCGATTG -> AAACGGTACTATGGTCTCGATTGT
CTCGCGCCACGAGCTACAACACAC -> TCGCGCCACGAGCTACAACACACC
CACGCTCAGGTAGGTACCGCGGAC -> ACGCTCAGGTAGGTACCGCGGACC
CCCAGATCCCGCCACTAGCCGCTG -> CCAGATCCCGCCACTAGCCGCTGT
CACACCGAAAACATGGTAAAAATG -> ACACCGAAAACATGGTAAAAATGC
TTTCTCACACGCAGCCCTGACTCG -> TTCTCACACGCAGCCCTGACTCGA
TACTACACTCTCGTTGAATAATTC -> ACTACACTCTCGTTGAATAATTCC
TGGTAAAAATGCCAAACATGCGCG -> GGTAAAAATGCCAAACATGCGCGA
CTACCGTTGATTCACACATCAAAC -> TACCGTTGATTCACACATCAAACG
GTTGAGCACGGAGACGGCGGCAAT -> TTGAGCACGGAGACGGCGGCAATA
AAAACACCCTGATATTATTACTAC -> AAACACCCTGATATTATTACTACA
AATGAGGCTGATTTATAAGCCAGA -> ATGAGGCTGATTTATAAGCCAGAC
TAATCGTAGAGAGCCCTGTGGCCC -> AATCGTAGAGAGCCCTGTGGCCCC
GTTAGCCGATATGCTTACAACTCG -> TTAGCCGATATGCTTACAACTCGC
TGGTATTAGGAGTGTCAAACAGCA -> GGTATTAGGAGTGTCAAACAGCAG
ACGGCTCGACCCGGTAGTCCGATG -> CGGCTCGACCCGGTAGTCCGATGG
GTCTAATGTTACCTCGACCATGGA -> TCTAATGTTACCTCGACCATGGAC
AACCTTATTATCCCGTCTTTGAAT -> ACCTTATTATCCCGTCTTTGAATG
TGATTCACACATCAAACGTTCGTG -> GATTCACACATCAAACGTTCGTGC
TTCGTGCCGCTGAGCAACGGACCA -> TCGTGCCGCTGAGCAACGGACCAC
CCTCCATTACGTCCCACGACTTCT -> CTCCATTACGTCCCACGACTTCTC
CTCGATTGTACAAAGGTTGCCTCT -> TCGATTGTACAAAGGTTGCCTCTG
TATCCGTTACATGGATTTGTCATG -> ATCCGTTACATGGATTTGTCATGT
TCCCCCGTAAATTTGTTACACCCT -> CCCCCGTAAATTTGTTACACCCTT
GACCAGCCCGCTCTCTCGCGTGGC -> ACCAGCCCGCTCTCTCGCGTGGCA
GTCAACCTACCGTTGATTCACACA -> TCAACCTACCGTTGATTCACACAT
GTAGAGAGCCCTGTGGCCCCCAAA -> TAGAGAGCCCTGTGGCCCCCAAAG
GTATTAGGAGTGTCAAACAGCAGA -> TATTAGGAGTGTCAAACAGCAGAT
ACTACACTCTCGTTGAATAATTCC -> CTACACTCTCGTTGAATAATTCCG
GTCCGATGGACCAGATCTCTATAG -> TCCGATGGACCAGATCTCTATAGT
ATTGCTCGCTCATCCAAGGTGTCA -> TTGCTCGCTCATCCAAGGTGTCAA
TCGAGCGCTGTCGTAGCAGCAGAA -> CGAGCGCTGTCGTAGCAGCAGAAT
GAATTGTGATCGATCACGCCAAGA -> AATTGTGATCGATCACGCCAAGAC
AGGGGGCGGGGCCCGACACGGCTG -> GGGGGCGGGGCCCGACACGGCTGC
TCCGACGGCTCGACCCGGTAGTCC -> CCGACGGCTCGACCCGGTAGTCCG
TTTTGGAGGTAAGATAACACGAAT -> TTTGGAGGTAAGATAACACGAATT
GAGCCACTTCGAATAATGGCGATG -> AGCCACTTCGAATAATGGCGATGC
TGTTGAGCACGGAGACGGCGGCAA -> GTTGAGCACGGAGACGGCGGCAAT
GTGCATAGCAACTTTGGCGACTAA -> TGCATAGCAACTTTGGCGACTAAA
ACTCGAGCGCTGTCGTAGCAGCAG -> CTCGAGCGCTGTCGTAGCAGCAGA
TGCCTCTGTGTAACGGGACCAGCC -> GCCTCTGTGTAACGGGACCAGCCC
TAGCCTCCCTTAAGTCACGGGGGG -> AGCCTCCCTTAAGTCACGGGGGGT
AGACGTAGCCTCCCTTAAGTCACG -> GACGTAGCCTCCCTTAAGTCACGG
GCTGGAACATGCCAACTGAGTTAG -> CTGGAACATGCCAACTGAGTTAGT
CTTAGTACGTCCGCTAATCTCGAC -> TTAGTACGTCCGCTAATCTCGACC
TAAGTGTAGCCTGTAACGCTGTAC -> AAGTGTAGCCTGTAACGCTGTACA
GCTAGAGGCAACAGTTTGGTATTA -> CTAGAGGCAACAGTTTGGTATTAG
TACACCGGATCGAGCGACTCAGAT -> ACACCGGATCGAGCGACTCAGATG
CGACCAACCTTATTATCCCGTCTT -> GACCAACCTTATTATCCCGTCTTT
TCTACAGGGGGCGGGGCCCGACAC -> CTACAGGGGGCGGGGCCCGACACG
TGCCCCAGATCCCGCCACTAGCCG -> GCCCCAGATCCCGCCACTAGCCGC
ATTAGGAGTGTCAAACAGCAGATT -> TTAGGAGTGTCAAACAGCAGATTT
CACTAGTGACAAGTGTTCATCTCA -> ACTAGTGACAAGTGTTCATCTCAC
ATTATTACTACATGCCGGTTCGAG -> TTATTACTACATGCCGGTTCGAGA
AGTACGTCCGCTAATCTCGACCAA -> GTACGTCCGCTAATCTCGACCAAC
TGGCCGATTTTTTACGGCCCTCAT -> GGCCGATTTTTTACGGCCCTCATT
CTTTGTTGAGCACGGAGACGGCGG -> TTTGTTGAGCACGGAGACGGCGGC
TCGTGGAGGTCACGCTCAGGTAGG -> CGTGGAGGTCACGCTCAGGTAGGT
CAACGGCACACACCGAAAACATGG -> AACGGCACACACCGAAAACATGGT
ACAGGCAGGTCAAACGGTACTATG -> CAGGCAGGTCAAACGGTACTATGG
ACCGTTGATTCACACATCAAACGT -> CCGTTGATTCACACATCAAACGTT
CCTCGCGCCACGAGCTACAACACA -> CTCGCGCCACGAGCTACAACACAC
TCGTAGGGAATAGTGTCAAGTCAC -> CGTAGGGAATAGTGTCAAGTCACC
TGTTCATCTCACCAATACTACAGG -> GTTCATCTCACCAATACTACAGGT
AAACGGTACTATGGTCTCGATTGT -> AACGGTACTATGGTCTCGATTGTA
CGGTTCGAGACCCTCCCTGCCTGC -> GGTTCGAGACCCTCCCTGCCTGCC
TCGAATAATGGCGATGCACGGGTG -> CGAATAATGGCGATGCACGGGTGA
CCTTATTATCCCGTCTTTGAATGA -> CTTATTATCCCGTCTTTGAATGAG
GAGCTTAGTACGTCCGCTAATCTC -> AGCTTAGTACGTCCGCTAATCTCG
CCGATATGCTTACAACTCGCACTT -> CGATATGCTTACAACTCGCACTTC
CCCTTCCGGCTGGTCAGATCCAGG -> CCTTCCGGCTGGTCAGATCCAGGT
ATCGTATATCGTAGGGAATAGTGT -> TCGTATATCGTAGGGAATAGTGTC
GTACCTATCCCCCGTAAATTTGTT -> TACCTATCCCCCGTAAATTTGTTA
CCAGATCCCGCCACTAGCCGCTGT -> CAGATCCCGCCACTAGCCGCTGTC
TCCACGCTTAACACAGGAAGTTAC -> CCACGCTTAACACAGGAAGTTACC
TTCGTTAACTTATGGCTTTCCACG -> TCGTTAACTTATGGCTTTCCACGC
TTATGCTCTGAGTTAGCCGATATG -> TATGCTCTGAGTTAGCCGATATGC
CACTGCCGCCCGGCACGCGGTAGT -> ACTGCCGCCCGGCACGCGGTAGTA
GTCGTAGCAGCAGAATGGGTGTCG -> TCGTAGCAGCAGAATGGGTGTCGA
GGTGGGTGCAGCAGTACTACACTC -> GTGGGTGCAGCAGTACTACACTCT
GACACAGATCGATGCACGTTTCGA -> ACACAGATCGATGCACGTTTCGAA
AAATCCTTGCACAGTTCCGCTGGA -> AATCCTTGCACAGTTCCGCTGGAA
CTTAACCGTTTCTGCAACTGACCC -> TTAACCGTTTCTGCAACTGACCCT
CTGCCCCAGATCCCGCCACTAGCC -> TGCCCCAGATCCCGCCACTAGCCG
CCACGAGCTACAACACACCGAAGT -> CACGAGCTACAACACACCGAAGTT
TATTGCTAAACCCAAGACGGGACG -> ATTGCTAAACCCAAGACGGGACGA
GATGGACCAGATCTCTATAGTGAA -> ATGGACCAGATCTCTATAGTGAAG
GTCCCTCGCGCCACGAGCTACAAC -> TCCCTCGCGCCACGAGCTACAACA
GTCCGACGGCTCGACCCGGTAGTC -> TCCGACGGCTCGACCCGGTAGTCC
AGTGTCAAACAGCAGATTTACGAG -> GTGTCAAACAGCAGATTTACGAGA
TCAAACGGTACTATGGTCTCGATT -> CAAACGGTACTATGGTCTCGATTG
CCAGACCGAACATTACCTTTGAGC -> CAGACCGAACATTACCTTTGAGCA
ATGGAGAGGTATTTCTTATTCTTT -> TGGAGAGGTATTTCTTATTCTTTC
CTCCCTTAAGTCACGGGGGGTGCA -> TCCCTTAAGTCACGGGGGGTGCAT
TTAACTTATGGCTTTCCACGCTTA -> TAACTTATGGCTTTCCACGCTTAA
CTCGTTGAATAATTCCGCAGATTA -> TCGTTGAATAATTCCGCAGATTAA
ACGATGTTGCCATCAATTCTGCAG -> CGATGTTGCCATCAATTCTGCAGG
AGGTCAAAGGGGTAAAACACCCTG -> GGTCAAAGGGGTAAAACACCCTGA
ACTGTTCAGATCGAGACGTAGCCT -> CTGTTCAGATCGAGACGTAGCCTC
GTTTCGAAACTATATGCCTTCGTT -> TTTCGAAACTATATGCCTTCGTTA
AAGGGCACGGATAATCGTAGAGAG -> AGGGCACGGATAATCGTAGAGAGC
AGGAGCCACTTCGAATAATGGCGA -> GGAGCCACTTCGAATAATGGCGAT
CGCAGCCCTGACTCGAGCGCTGTC -> GCAGCCCTGACTCGAGCGCTGTCG
CACTTCGGACATCGAATCTGTTAT -> ACTTCGGACATCGAATCTGTTATG
AAGAGTTAGTTTAACGTATCGCTT -> AGAGTTAGTTTAACGTATCGCTTT
CACAGGAAGTTACCCAAAATACAT -> ACAGGAAGTTACCCAAAATACATA
GACCACCCTACAAGAGTTAGTTTA -> ACCACCCTACAAGAGTTAGTTTAA
ACCCAAGACGGGACGATGTTGCCA -> CCCAAGACGGGACGATGTTGCCAT
CGCTGGAACATGCCAACTGAGTTA -> GCTGGAACATGCCAACTGAGTTAG
GAATCTGTTATGTCTGGCCTAACC -> AATCTGTTATGTCTGGCCTAACCA
GTTACCTCGACCATGGACACAGAT -> TTACCTCGACCATGGACACAGATC
CAGCCCTGACTCGAGCGCTGTCGT -> AGCCCTGACTCGAGCGCTGTCGTA
GAAGTTTTGGAGGTAAGATAACAC -> AAGTTTTGGAGGTAAGATAACACG
CGTCGAATATCCGTTACATGGATT -> GTCGAATATCCGTTACATGGATTT
ACCCTACAAGAGTTAGTTTAACGT -> CCCTACAAGAGTTAGTTTAACGTA
GTAAGATAACACGAATTGCGCTTA -> TAAGATAACACGAATTGCGCTTAA
CGGACCACCCTACAAGAGTTAGTT -> GGACCACCCTACAAGAGTTAGTTT
CGCACAATGGCAGTAGAATTGTGA -> GCACAATGGCAGTAGAATTGTGAT
ACGGATAATCGTAGAGAGCCCTGT -> CGGATAATCGTAGAGAGCCCTGTG
AGATAACACGAATTGCGCTTAACC -> GATAACACGAATTGCGCTTAACCG
CCGTTCTGGAATCGTGGAGGTCAC -> CGTTCTGGAATCGTGGAGGTCACG
ACCAGATCTCTATAGTGAAGACCG -> CCAGATCTCTATAGTGAAGACCGG
GCAAGAACGCCTGTTGTGCCAGTT -> CAAGAACGCCTGTTGTGCCAGTTC
TCCGATCCGTCCCCAATAGGTGAC -> CCGATCCGTCCCCAATAGGTGACG
CCTTGCACAGTTCCGCTGGAACAT -> CTTGCACAGTTCCGCTGGAACATG
ATACATAGCAGGACCCAATATCTA -> TACATAGCAGGACCCAATATCTAC
TCACGGGGGGTGCATAGCAACTTT -> CACGGGGGGTGCATAGCAACTTTG
CATCCAAGGTGTCAATGTTCCATC -> ATCCAAGGTGTCAATGTTCCATCG
TTGAATGAGGCTGATTTATAAGCC -> TGAATGAGGCTGATTTATAAGCCA
GGCGGCAATATCTCAGGCTAGAGG -> GCGGCAATATCTCAGGCTAGAGGC
CGTTCTGGAATCGTGGAGGTCACG -> GTTCTGGAATCGTGGAGGTCACGC
ACGTCCCTCGCGCCACGAGCTACA -> CGTCCCTCGCGCCACGAGCTACAA
AGTTTGGTATTAGGAGTGTCAAAC -> GTTTGGTATTAGGAGTGTCAAACA
AAGTTTTGGAGGTAAGATAACACG -> AGTTTTGGAGGTAAGATAACACGA
GGGGGGTGCATAGCAACTTTGGCG -> GGGGGTGCATAGCAACTTTGGCGA
GAGGTCAAAGGGGTAAAACACCCT -> AGGTCAAAGGGGTAAAACACCCTG
AAAGCAAGTCATGGAACGTCCTTC -> AAGCAAGTCATGGAACGTCCTTCA
ACGTCCCACGACTTCTCATGGAAG -> CGTCCCACGACTTCTCATGGAAGA
TTAATAGTGATACTCCGAACGTAA -> TAATAGTGATACTCCGAACGTAAT
GATCGAGCGACTCAGATGTAAGTC -> ATCGAGCGACTCAGATGTAAGTCT
AAGGAGCCACTTCGAATAATGGCG -> AGGAGCCACTTCGAATAATGGCGA
GGTCAAACGGTACTATGGTCTCGA -> GTCAAACGGTACTATGGTCTCGAT
AATAGGTGACGTGAAACCACGTCC -> ATAGGTGACGTGAAACCACGTCCT
CGCCTGTTGTGCCAGTTCAAACGA -> GCCTGTTGTGCCAGTTCAAACGAT
GGAACATGCCAACTGAGTTAGTGG -> GAACATGCCAACTGAGTTAGTGGC
ACCGTTTCTGCAACTGACCCTCTC -> CCGTTTCTGCAACTGACCCTCTCA
AGGAAGTTACCCAAAATACATAGC -> GGAAGTTACCCAAAATACATAGCA
AGTGTCGCGGTTTGTTCTCAAAGG -> GTGTCGCGGTTTGTTCTCAAAGGG
CCGCACAATGGCAGTAGAATTGTG -> CGCACAATGGCAGTAGAATTGTGA
CGAGAGCTTAGTACGTCCGCTAAT -> GAGAGCTTAGTACGTCCGCTAATC
TAATAGTGATACTCCGAACGTAAT -> AATAGTGATACTCCGAACGTAATG
CTCTCGTTGAATAATTCCGCAGAT -> TCTCGTTGAATAATTCCGCAGATT
TCTCACACGCAGCCCTGACTCGAG -> CTCACACGCAGCCCTGACTCGAGC
AACGGTACTATGGTCTCGATTGTA -> ACGGTACTATGGTCTCGATTGTAC
GAGCAGCTCGGTGAGTGTCGCGGT -> AGCAGCTCGGTGAGTGTCGCGGTT
TCGGCACTAGTGACAAGTGTTCAT -> CGGCACTAGTGACAAGTGTTCATC
ATTAAGTCCGACGGCTCGACCCGG -> TTAAGTCCGACGGCTCGACCCGGT
AATCGTGGAGGTCACGCTCAGGTA -> ATCGTGGAGGTCACGCTCAGGTAG
AACTGAGTTAGTGGCCGATTTTTT -> ACTGAGTTAGTGGCCGATTTTTTA
ATATCGTAGGGAATAGTGTCAAGT -> TATCGTAGGGAATAGTGTCAAGTC
CGACTCAGATGTAAGTCTATAGCA -> GACTCAGATGTAAGTCTATAGCAA
ACGCTTAACACAGGAAGTTACCCA -> CGCTTAACACAGGAAGTTACCCAA
GTAGTACCTATCCCCCGTAAATTT -> TAGTACCTATCCCCCGTAAATTTG
GCTAATCTCGACCAACCTTATTAT -> CTAATCTCGACCAACCTTATTATC
CCCTGCCTGCCTCGAGTTGTCTCT -> CCTGCCTGCCTCGAGTTGTCTCTA
CAGCAGAATGGGTGTCGAAGCCTC -> AGCAGAATGGGTGTCGAAGCCTCT